的	dk·白勹丶丶丶丶
一	je·一一一一一一
了	cu·了ㄋ丨丨丨丨
是	si·是丨ㄋ一一一
不	he·不一丿丨丶丶
我	wo·我丿一丨一ㄋ
他	jd·亻也ㄋ丨ㄋㄋ
在	dl·土一丨一一
人	do·人丿丶丶丶丶
有	dh·⺝丨ㄋ一一
这	nr·文辶丶ㄋ丶丶
来	wn·𰀆𡭔丨丿丶丶
你	ja·亻尔丿ㄋ丨丿
个	dj·人丨丨丨丨丨
上	li·上丨一一一一
到	gn·至刂丨丨丨丨
大	ke·大一丿丶丶丶
道	aj·䒑自丶ㄋ丶丶
着	kb·目丨ㄋ一一
说	sk·讠𠮦丿ㄋㄋㄋ
她	md·女也ㄋ丨ㄋㄋ
们	jf·亻门丶丨ㄋㄋ
也	du·也ㄋ丨ㄋㄋㄋ
就	lx·京尢丶丶丶丶
那	sy·阝ㄋ丨丨丨
地	ld·土也ㄋ丨ㄋㄋ
中	vi·中丨ㄋ一丨丨
子	su·子ㄋ丨一一一
出	ys·屮凵ㄋ丨丨丨
要	tm·覀女ㄋ丿一一
下	le·下一丨丶丶丶
为	jw·丶力丶丶丶丶
得	fq·彳旦一丨丶丶
和	ck·禾口丨ㄋ一一
么	jc·丿厶ㄋ丶丶丶
时	wj·日寸一丨丶丶
可	ge·可一丨ㄋ一丨
去	we·去一丨一ㄋ丶
会	dm·人云一一ㄋ丶
里	gi·里丨ㄋ一一丨
过	jr·寸辶丶ㄋ丶丶
以	bu·以ㄋ丶丿丶丶
看	nb·目丨ㄋ一一
然	bp·犬丶丶丶丶
对	fj·又寸一丨丶丶
自	jo·自丿丨ㄋ一一
好	ms·女子ㄋ丨一一
天	fe·天一一丿丶丶
之	kr·之丶ㄋ丶丶丶
没	nd·氵殳丿ㄋㄋ丶
都	fy·者阝ㄋ丨丨丨
小	ci·小丨丿丶丶丶
心	lr·心丶ㄋ丶丶丶
能	ch·厶⺝丿ㄋㄋㄋ
还	hr·不辶丶ㄋ丶丶
而	ye·而一丿丨ㄋ丨
后	al·一丨ㄋ一
想	vl·相心丶ㄋ丶丶
起	mg·走己ㄋ一ㄋㄋ
生	go·生丿一一丨一
家	vh·宀豕一丿ㄋ丿
只	kf·口八丿丶丶丶
多	bb·夕夕丿ㄋ丶丶
手	no·手丿一一丨丨
事	ls·肀ㄋ一一丨
面	heo·面一丿丨ㄋ丨
国	ks·囗王丶丶丶丶
头	wk·⺀大一丿丶丶
发	xu·发ㄋ丿ㄋ丶丶
如	mk·女口丨ㄋ一一
无	jx·一尢一丿ㄋㄋ
身	zo·身丿丨ㄋ一一
用	to·用丿ㄋ一一丨
又	fu·又ㄋ丶丶丶丶
把	gg·扌巴ㄋ丨一ㄋ
样	tk·木羊丶丿一一
开	ne·开一一丿丨丨
于	ae·于一一丨丨丨
点	tn·占灬丶丶丶丶
前	ar·前丶丿一丨ㄋ
已	gu·已ㄋ一ㄋㄋㄋ
知	vk·矢口丨ㄋ一一
什	jp·亻十一丨丨丨
所	av·丿丿一丨
方	mr·方丶一ㄋ丿丿
现	sf·王见丿ㄋㄋㄋ
经	xp·纟轻ㄋ丶一丨
见	fi·见丨ㄋ丿ㄋㄋ
成	kt·戊ㄋㄋㄋㄋ
些	ty·此二一一一一
法	nw·氵去一丨一ㄋ
行	fa·彳亍一一丨丨
声	lz·士ㄋ丨一丿
年	vj·一丨一丨
意	ml·音心丶ㄋ丶丶
己	gue·己ㄋ一ㄋㄋㄋ
当	cc·彐ㄋ一一一
但	jq·亻旦丨ㄋ一一
笑	lf·夭丿一丿丶
老	fn·耂匕丿ㄋㄋㄋ
两	ff·丙从丿丶丿丶
很	fh·彳艮ㄋ一一ㄋ
情	hh·忄青一一丨一
从	fo·从丿丶丿丶丶
作	jz·亻乍丿一丨一
动	mw·云力ㄋ丿丿丿
话	sn·讠舌丿一丨丨
回	xi·回丨ㄋ丨ㄋ一
力	wu·力ㄋ丿丿丿丿
儿	xo·儿丿ㄋㄋㄋㄋ
三	pe·三一一一一一
长	bo·长丿一ㄋ丶丶
走	me·走一丨一丨一
明	wh·日月丿ㄋ一一
间	fw·门日丨ㄋ一一
同	sl·冂一丨ㄋ一
分	so·分丿丶ㄋ丿丿
气	vo·气丿一一ㄋㄋ
十	pei·十一丨丨丨丨
眼	bh·目艮ㄋ一一ㄋ
女	mu·女ㄋ丿一一一
将	zb·丬夕一丨丶丶
定	pr·定丶丶ㄋ一丨
种	cv·禾中丨ㄋ一丨
进	yr·井辶丶ㄋ丶丶
本	tj·木一一一一一
此	ti·此丨一丨一丿
向	zk·口丨ㄋ一一
正	kei·正一丨一丨一
真	hf·直八丿丶丶丶
实	vw·宀⺀一丿丶丶
给	xc·纟合丿丶一丨
高	gk·口丨ㄋ一一
被	hz·衤皮ㄋ丿丨ㄋ
学	ns·子ㄋ丨一一
问	fk·门口丨ㄋ一一
神	hw·礻日丨丨丨丨
与	qj·与一一一一一
再	fl·丙土一丨一一
才	te·才一丨丿丿丿
全	ds·人王一一丨一
太	kj·大丶丶丶丶丶
因	qi·因丨ㄋ一丿丶
其	gei·其一丨丨一一
主	kre·主丶一一丨一
日	wi·日丨ㄋ一一一
打	ga·扌丁一丨丨丨
却	ww·去卩ㄋ丨丨丨
让	sli·讠上丨一一一
文	nre·文丶一丿丶丶
最	wy·日耳ㄋ丶丶丶
口	ki·口丨ㄋ一一一
听	kq·口斤丿丿一丨
外	bl·夕卜丨丶丶丶
二	yee·二一一一一一
门	fr·门丶丨ㄋㄋㄋ
几	ao·几丿ㄋㄋㄋㄋ
理	sg·王里丨ㄋ一一
公	co·公丿丶ㄋ丶丶
等	ll·土一丨丶丶
相	ve·相一丨丿丶丨
光	hi·光丨丶丿一丿
西	tei·西一丨ㄋ丿ㄋ
白	doi·白丿丨ㄋ一一
先	goe·先丿一丨一丿
者	fei·者一丨一丿丨
便	jb·亻更一丨ㄋ一
住	jk·亻主丶一一丨
使	jl·亻丿丶丶丶
并	an·䒑廾一丿丨丨
重	ng·千里丨ㄋ一一
信	js·亻言丶一一一
斯	gq·其斤丿丿一丨
感	kl·戊丶ㄋ丶丶
做	jv·亻古丿一丿丶
水	ni·水丨ㄋ丿丶丶
新	ht·立朩丿丿一丨
风	ah·几乂丿丶丶丶
应	am·广丶丶丿一
少	vio·少丨丿丶丿丿
边	wr·力辶丶ㄋ丶丶
觉	nf·见丨ㄋ丿ㄋ
色	dg·巴ㄋ丨一ㄋ
别	kw·口力丨丨丨丨
名	bk·夕口丨ㄋ一一
特	cl·牜土一丨丶丶
何	jg·亻可一丨ㄋ一
次	pre·次丶一丿ㄋ丿
山	yi·山丨ㄋ丨丨丨
机	ta·木几丿ㄋㄋㄋ
吧	kg·口巴ㄋ丨一ㄋ
位	jh·亻立丶一丶丿
比	meu·比一ㄋ丿ㄋㄋ
关	ak·䒑大一丿丶丶
体	jt·亻木一一一一
部	hk·立口ㄋ丨丨丨
第	lxi·弓丨丿丿丿
果	wt·日木一丨丿丶
马	au·马ㄋㄋ一一一
死	bn·歹匕丿ㄋㄋㄋ
处	nl·夂卜丨丶丶丶
怎	zl·乍心丶ㄋ丶丶
安	vm·宀女ㄋ丿一一
东	yc·小丨丿丶丶
像	jwo·亻象丿ㄋ丨ㄋ
四	ciu·四丨ㄋ丿ㄋ一
工	lei·工一丨一一一
王	se·王一一丨一一
更	be·更一丨ㄋ一一
月	ho·月丿ㄋ一一一
由	ai·由丨ㄋ一丨一
金	vor·金丿丶一一丨
呢	kz·口尸丿ㄋㄋㄋ
尔	aou·尔丿ㄋ丨丿丶
直	hei·直一丨丨ㄋ
数	qm·米女丿一丿丶
内	liu·内丨ㄋ丿丶丶
它	vn·宀匕丿ㄋㄋㄋ
路	zz·各丿ㄋ丶丨
快	hv·忄丿丶丶丶
美	kk·大一丿丶丶
叫	kbu·口丩ㄋ丨丨丨
吗	ka·口马ㄋㄋ一一
军	qy·冖车一ㄋ一丨
接	gh·扌立ㄋ丿一一
加	tu·加ㄋ丿丨ㄋ一
平	her·平一丶丿一丨
张	xb·弓长丿一ㄋ丶
望	xh·亡月一一丨一
常	cy·巾丨ㄋ丨丨
放	mn·方攵丿一丿丶
表	xj·丿ㄋ丿丶
难	fm·又隹丿丨丶一
性	hg·忄生丿一一丨
入	dor·入丿丶丶丶丶
场	lt·土㇡丿丿丿丿
算	lb·目一丿丨丨
海	nv·氵ㄋㄋ丶一
脸	hq·月亼丶丶丿一
花	fyo·艹化丿丨丿ㄋ
龙	leo·龙一丿ㄋ丿丶
连	yrr·车辶丶ㄋ丶丶
战	tke·占戈一ㄋ丿丶
轻	yp·车轻ㄋ丶一丨
爱	yd·ㄋ丶丶丶
夫	jee·夫一一丿丶丶
利	cn·禾刂丨丨丨丨
带	fqi·冖丨ㄋ丨丨
亲	hte·立朩一丨丿丶
合	cor·合丿丶一丨ㄋ
通	tr·甬辶丶ㄋ丶丶
清	nh·氵青一一丨一
立	hre·立丶一丶丿一
候	jvo·丿一一丿
目	bi·目丨ㄋ一一一
民	qu·民ㄋ一ㄋ一ㄋ
系	jdu·丿糸ㄋㄋ丶丨
拉	ghr·扌立丶一丶丿
变	pf·亦又ㄋ丶丶丶
五	jei·五一丨ㄋ一一
原	ad·厂白丨丿丶丶
完	vle·宀元一一丿ㄋ
结	xn·纟吉一丨一丨
化	yo·化丿丨丿ㄋㄋ
跟	zh·艮ㄋ一一ㄋ
世	dp·廿乚ㄋㄋㄋㄋ
空	dle·穴工一丨一一
受	yf·又ㄋ丶丶丶
车	yeu·车一ㄋ一丨丨
教	fs·耂子丿一丿丶
今	qo·今丿丶丶ㄋㄋ
业	ji·业丨丨丶丿一
啊	ky·口阝一丨ㄋ一
许	sv·讠一丨丨丨
强	xk·弓口丨ㄋ一丨
飞	pw·丿丶丶丶
德	fp·彳十丨ㄋ丨丨
解	hs·角刀丿一一丨
电	wp·日乚ㄋㄋㄋㄋ
量	qg·旦里丨ㄋ一一
思	gl·田心丶ㄋ丶丶
总	klr·𠮦心丶ㄋ丶丶
任	jso·亻壬丿一丨一
物	cj·牜勿丿ㄋ丿丿
度	df·度又ㄋ丶丶丶
活	nn·氵舌丿一丨丨
件	jco·亻牛丿一一丨
林	mei·林一丨丿丶一
师	nj·一丨ㄋ丨丨
非	zi·非丨一一一丨
克	vx·古儿丿ㄋㄋㄋ
象	wou·象丿ㄋ丨ㄋ一
万	weu·万一ㄋ丿丿丿
该	sh·讠亥丶一ㄋ丿
命	qk·亼口ㄋ丨丨丨
士	leie·士一丨一一一
似	jbu·亻以ㄋ丶丿丶
城	lk·土戊ㄋㄋㄋㄋ
至	geu·至一ㄋ丶一丨
吃	kv·口ㄋㄋㄋㄋ
提	gs·扌是丨ㄋ一一
转	yy·车二ㄋ丶丶丶
制	vy·巾丨丨丨丨
市	by·亠巾丨ㄋ丨丨
黑	xiu·黑丨ㄋ丶丿一
火	pro·火丶丿丿丶丶
云	mee·云一一ㄋ丶丶
报	gw·扌卩ㄋ丶丶丶
指	gni·扌匕丨ㄋ一一
书	tt·丨丶丶丶
远	lrr·元辶丶ㄋ丶丶
找	gke·扌戈一ㄋ丿丶
满	nfe·氵艹一丨ㄋ丿
记	sgu·讠己ㄋ一ㄋㄋ
管	lv·宀丨ㄋ一ㄋ
干	nee·干一一丨丨丨
计	sp·讠十一丨丨丨
且	biu·且丨ㄋ一一一
红	xl·纟工一丨一一
房	tmr·户方丶一ㄋ丿
步	hc·止丨丿丿丿
必	lj·心丿丿丿丿丿
微	aa·几丿ㄋㄋㄋ
南	ps·十冂丶丿一一
字	vs·宀子ㄋ丨一一
反	af·又ㄋ丶丶丶
华	ype·化十一丨丨丨
百	jdo·一白丿丨ㄋ一
言	sr·言丶一一一丨
李	ts·木子ㄋ丨一一
认	sd·讠人丿丶丶丶
往	fkr·彳主丶一一丨
形	nwo·开彡丿丿丿丿
服	hwu·月卩ㄋ丶丶丶
倒	jgi·亻至丨丨丨丨
离	ql·㐫禸丨ㄋㄋ丶
刚	shi·冂㐅丨丨丨丨
虽	kbi·口虫丨ㄋ一丨
罗	cb·罒夕丿ㄋ丶丶
双	fur·双ㄋ丶ㄋ丶丶
告	joe·告丿一丨一丨
站	hti·立占丨一丨ㄋ
乎	bor·乎丿丶丿一丨
流	nx·氵丿丨ㄋㄋ
或	kke·戈口一一一一
坐	fle·从土一丨一一
深	nq·氵冖丿丶一丨
冷	wq·冫令丿丶丶ㄋ
各	zou·各丿ㄋ丶丨ㄋ
传	jy·亻二ㄋ丶丶丶
音	mre·音丶一丶丿一
息	jlr·自心丶ㄋ丶丶
石	de·石一丿丨ㄋ一
及	sou·及丿ㄋ丶丶丶
保	jsi·亻呆丨ㄋ一一
语	sj·讠五丨ㄋ一一
剑	qmi·亼丨丨丨丨
交	qh·六乂丿丶丶丶
若	fd·艹丨ㄋ一一
容	dd·穴人丨ㄋ一一
怕	hd·忄白丿丨ㄋ一
条	nt·夂朩一丨丿丶
界	gd·田人丿丨丨丨
半	jro·半丶丿一一丨
达	krr·大辶丶ㄋ丶丶
奇	kge·大可一丨ㄋ一
青	hee·青一一丨一丨
题	sne·是页一丿丨ㄋ
早	wpe·日十一丨丨丨
元	lee·元一一丿ㄋㄋ
建	sru·聿廴ㄋ丶丶丶
失	jj·丿夫一一丿丶
近	qr·斤辶丶ㄋ丶丶
惊	hl·忄京丶一丨ㄋ
则	dn·贝刂丨丨丨丨
魔	yso·麻鬼丿丨ㄋ一
即	tw·卩ㄋ丨丨丨
队	ydo·阝人丿丶丶丶
程	cke·禾口一一丨一
切	nsu·七刀ㄋ丿丿丿
衣	jre·衣丶一丿ㄋ丿
谁	sm·讠隹丿丨丶一
北	zie·北丨一一丿ㄋ
落	yz·落各丿ㄋ丶丨
杀	htei·乂朩一丨丿丶
式	kle·弋工一丨一一
精	qhe·米青一一丨一
酒	nte·氵酉一丨ㄋ丿
产	ha·厂一丿丿丿
请	she·讠青一一丨一
论	sa·讠仑丿丶丿ㄋ
统	xx·纟丿ㄋㄋㄋ
决	wv·冫丿丶丶丶
星	wg·日生丿一一丨
义	nro·义丶丿丶丶丶
刻	hn·亥刂丨丨丨丨
极	tso·木及丿ㄋ丶丶
未	dee·未丨丿丶丶丶
求	wei·求一丨丶一丿
随	ydi·阝丨ㄋ一一
竟	mx·音儿丿ㄋㄋㄋ
格	tz·木各丿ㄋ丶丨
影	wl·日京丿丿丿丿
每	vv·母ㄋㄋ丶一
区	meo·区一丿丶ㄋㄋ
兴	mf·八丿丶丶丶
紧	mdu·糸ㄋㄋ丶丨
兵	qf·丘八丿丶丶丶
办	wf·力八丿丶丶丶
展	zp·尸ㄋ丿丶丶
始	mc·女厶丨ㄋ一一
八	for·八丿丶丶丶丶
功	lw·工力ㄋ丿丿丿
武	jki·一弋丨一丨一
政	kn·正攵丿一丿丶
喜	aki·壴口丨ㄋ一一
拿	cno·合手丿一一丨
孩	shr·孑亥丶一ㄋ丿
男	gwu·田力ㄋ丿丿丿
员	kd·口贝丨ㄋ丿丶
灵	cp·彐火丶丿丿丶
阿	yg·阝可一丨ㄋ一
务	nwu·夂力ㄋ丿丿丿
江	nle·氵工一丨一一
钱	vke·钅戋一一ㄋ丿
根	th·木艮ㄋ一一ㄋ
图	knr·囗夂丶丶丶丶
布	dy·巾丨ㄋ丨丨
您	jar·亻尔丶ㄋ丶丶
令	qor·令丿丶丶ㄋ丶
突	dpe·穴犬一丿丶丶
设	sdo·讠殳丿ㄋㄋ丶
据	gz·扌尸一丨丨ㄋ
绝	xd·纟ㄋ丨一ㄋ
收	bno·丩攵丿一丿丶
越	mke·走戉一ㄋㄋ丿
整	zn·束攵一丨一丨
基	gle·其土一丨一一
院	yv·阝宀一一丿ㄋ
姐	mb·女且丨ㄋ一一
父	lo·父丿丶丿丶丶
怪	hfe·忄又一丨一一
期	gho·其月丿ㄋ一一
术	tjr·木丶丶丶丶丶
暗	wm·日音丶一丶丿
九	gou·九丿ㄋㄋㄋㄋ
店	at·广占丨一丨ㄋ
乐	pc·小丨丿丶丶
识	sko·讠口丿丶丶丶
友	dfu·又ㄋ丶丶丶
般	pd·舟殳丿ㄋㄋ丶
片	ko·片丿丨一ㄋㄋ
七	neu·七一ㄋㄋㄋㄋ
尽	kwr·尺⺀丶丶丶丶
哪	ksu·口ㄋ丨丨丨
集	mt·隹木一丨丿丶
阳	yw·阝日丨ㄋ一一
客	vz·宀各丿ㄋ丶丨
伤	jvu·亻ㄋ丿丿丿
答	lc·合丿丶一丨
夜	bj·亠亻丿ㄋ丶丶
领	qn·令页一丿丨ㄋ
千	noe·千丿一丨丨丨
周	snei·冂吉一丨一丨
装	zlr·丬士丶一丿ㄋ
写	qq·冖与一一一一
苦	fv·艹古一丨丨ㄋ
血	jci·丿皿丨ㄋ丨丨
视	hfi·礻见丨ㄋ丿ㄋ
击	lsu·凵ㄋ丨丨丨
取	yfu·耳又ㄋ丶丶丶
消	nc·氵丨ㄋ一一
司	tl·一丨ㄋ一
弟	xr·弟丶丿ㄋ一ㄋ
哥	gge·可可一丨ㄋ一
玉	sjr·王丶丶丶丶丶
静	hb·青争丿ㄋㄋ一
阵	yye·阝车一ㄋ一丨
单	hro·单丶丿丨ㄋ一
亚	sei·亚一丨丨丶丿
代	boi·代丿丨一ㄋ丶
运	mrr·云辶丶ㄋ丶丶
六	qre·六丶一丿丶丶
众	dfo·人从丿丶丿丶
品	kh·口吅丨ㄋ一丨
足	km·口龰丨一丿丶
族	dv·𭤨矢丿一一丿
科	cw·禾⺀一丨丨丨
类	qke·米大一丿丶丶
雷	pg·田丨ㄋ一丨
断	qp·米乚丿丿一丨
社	hle·礻土一丨一一
留	pgi·田丨ㄋ一丨
晚	wwo·日丿ㄋㄋㄋ
兰	ay·䒑二一一一一
谈	spr·讠火丶丿丿丶
器	hp·吅犬丨ㄋ一丨
准	wmo·冫隹丿丨丶一
够	kko·勹口丿ㄋ丶丿
确	dho·石角丿ㄋ丿ㄋ
易	wjo·日勿丿ㄋ丿丿
黄	pa·由丿丶丶丶
复	vwo·日丿ㄋ丶丶
送	akr·䒑大丶ㄋ丶丶
团	kte·囗才一丨丿丿
句	kki·勹口丨ㄋ一一
官	vhi·宀㠯丨ㄋ一ㄋ
敢	tyo·乛耳丿一丿丶
修	jn·夂丿丿丿丿
照	ws·日刀丨ㄋ一丶
丽	ce·丽一丨ㄋ丶丨
备	ngi·夂田丨ㄋ一丨
急	xlr·刍心丶ㄋ丶丶
忙	hx·忄亡丶一ㄋㄋ
母	vu·母ㄋㄋ丶一丶
欢	fao·又欠丿ㄋ丿丶
英	fse·艹冂一丿丶丶
古	vei·古一丨丨ㄋ一
底	amr·广氏丶丶丶丶
巴	gui·巴ㄋ丨一ㄋㄋ
帮	xy·阝丨ㄋ丨丨
终	xnr·纟夂丶丶丶丶
势	dw·执力ㄋ丿丿丿
娘	mj·女丶ㄋ一一ㄋ
热	dnr·执灬丶丶丶丶
显	wji·日业丨丨丶丿
朝	xho·月丿ㄋ一一
错	vp·钅龷丨ㄋ一一
持	glei·扌土一丨丶丶
调	ss·讠冂一丨一丨
宝	vsr·宀王丶丶丶丶
香	cwi·禾日丨ㄋ一一
低	jm·亻氏丶丶丶丶
丝	pp·一一一一
曾	wro·曾丶丿丨ㄋ丨
冲	wvi·冫中丨ㄋ一丨
线	xke·纟戋一一ㄋ丿
级	xs·纟及丿ㄋ丶丶
示	see·示一一丨丿丶
改	gno·己攵丿一丿丶
待	flei·彳土一丨丶丶
包	kgu·勹巳ㄋ一ㄋㄋ
台	cki·厶口丨ㄋ一一
沉	nqo·氵冖丿ㄋㄋㄋ
愿	adi·厂白丨丿丶丶
久	tou·久丿ㄋ丶丶丶
希	hdi·乂丨ㄋ丨丨
木	teio·木一丨丿丶丶
响	kzi·口丨ㄋ一一
破	dz·石皮ㄋ丿丨ㄋ
首	ajo·䒑自丿丨ㄋ一
模	tye·木莫一丨丨丨
脚	hwui·月去ㄋ丨丨丨
害	vxi·宀丰丨ㄋ一一
约	xkr·纟勹丶丶丶丶
资	pdi·次贝丨ㄋ丿丶
穿	da·穴牙一ㄋ丨丿
联	ya·耳䒑一丿丶丶
哈	kc·口合丿丶一丨
树	tf·木又一丨丶丶
雪	pcu·彐ㄋ一一一
楚	mm·林疋ㄋ丨一丿
注	nk·氵主丶一一丨
引	xji·弓丨丨丨丨丨
护	gt·扌户丶ㄋ一丿
另	kwu·口力ㄋ丿丿丿
故	vno·古攵丿一丿丶
村	tje·木寸一丨丶丶
存	dsu·子ㄋ丨一一
嘴	kto·口此丿ㄋ丿ㄋ
依	jjr·亻衣丶一丿ㄋ
诉	sq·讠斤丶丶丶丶
造	jrr·告辶丶ㄋ丶丶
技	gp·扌十ㄋ丶丶丶
露	pz·丿ㄋ丶丨
除	yq·阝亼一丨丿丶
慢	hwi·忄日丨ㄋ丨丨
具	bf·八丿丶丶丶
摇	gy·扌爫丿一一丨
观	ffi·又见丨ㄋ丿ㄋ
楼	tq·木米ㄋ丿一一
商	hso·冂丿丶丨ㄋ
型	nne·开刂一丨一一
府	aje·广亻一丨丶丶
停	jge·亻一丨丨丨
爷	lwu·父卩ㄋ丨丨丨
铁	vje·钅丿一一丿丶
段	goi·段丿丨一一一
广	are·广丶一丿丿丿
念	qlr·今心丶ㄋ丶丶
组	xbi·纟且丨ㄋ一一
节	fwu·艹卩ㄋ丨丨丨
需	py·而一丿丨ㄋ
议	snr·讠义丶丿丶丶
举	mfe·八一一丨丨
支	pfu·十又ㄋ丶丶丶
细	xg·纟田丨ㄋ一丨
跑	zku·勹ㄋ一ㄋㄋ
维	xm·纟隹丿丨丶一
异	gne·巳廾一丿丨丨
陈	yyi·阝丨丿丶丶
乱	np·舌乚ㄋㄋㄋㄋ
况	wko·冫口丿ㄋㄋㄋ
忽	jlru·勿心丶ㄋ丶丶
妈	ma·女马ㄋㄋ一一
刀	suo·刀ㄋ丿丿丿丿
痛	ltu·疒甬ㄋ丶丨ㄋ
群	ckr·尹口丶丿一一
居	zv·尸古一丨丨ㄋ
速	zr·束辶丶ㄋ丶丶
兄	kx·口儿丿ㄋㄋㄋ
睛	bhe·目青一一丨一
究	dgo·穴九丿ㄋㄋㄋ
斗	wpei·⺀十一丨丨丨
卡	lli·上卜丨丶丶丶
甚	gpu·其乚ㄋㄋㄋㄋ
帝	hy·巾丨ㄋ丨丨
喝	kwo·口日丿ㄋ丿丶
态	kjr·大丶丶ㄋ丶丶
怀	hhe·忄不一丿丨丶
局	zt·尸丨ㄋ一一
派	na·氵丿ㄋ丿丶
杨	tto·木㇡丿丿丿丿
谢	sz·讠身一丨丶丶
脑	hqr·月㐫丶一丿丶
病	lfo·疒丙丿丶丿丶
顿	bne·屯页一丿丨ㄋ
治	nci·氵厶丨ㄋ一一
福	hli·礻丨ㄋ一丨
角	hou·角丿ㄋ丿ㄋ一
旁	hm·方丶一ㄋ丿
威	kju·戊一ㄋ丿一一
叶	kp·口十一丨丨丨
京	lre·京丶一丨ㄋ一
围	kje·囗韦一一ㄋ丨
园	klee·囗元一一丿ㄋ
皮	zu·皮ㄋ丿丨ㄋ丶
雨	peiu·雨一丨ㄋ丨丶
号	kwe·口丂一ㄋㄋㄋ
密	vlo·宀心丿丨ㄋ丨
须	wne·彡页一丿丨ㄋ
推	gm·扌隹丿丨丶一
背	zhi·北⺝丨ㄋ一一
河	nge·氵可一丨ㄋ一
亮	gao·几丿ㄋㄋㄋ
姑	mv·女古一丨丨ㄋ
证	ske·讠正一丨一丨
费	xni·弓丨ㄋ丿丶
汉	nfu·氵又ㄋ丶丶丶
志	llr·士心丶ㄋ丶丶
查	tqi·木旦丨ㄋ一一
圣	fleie·又土一丨一一
呼	kbo·口乎丿丶丿一
讲	sye·讠井一一丿丨
续	xpu·纟十ㄋ丶丶一
标	tse·木示一一丨丿
共	peii·共一丨丨一
尼	zno·尸匕丿ㄋㄋㄋ
米	qro·米丶丿一丨丿
际	yse·阝示一一丨丿
招	gsi·扌刀丨ㄋ一一
超	msi·走刀丨ㄋ一一
差	klei·工一丨一一
仍	jwu·亻乃ㄋ丿丿丿
块	lvo·土丿丶丶丶
莫	yei·莫一丨丨丨ㄋ
游	ndu·氵𭤨ㄋ丨一一
药	fx·艹纟丿ㄋ丶丶
船	pai·舟几丨ㄋ一一
网	sho·冂乂丿丶丶丶
掌	cnoe·手丿一一丨
呀	kae·口牙一ㄋ丨丿
掉	gli·扌⺊丨ㄋ一一
皇	dse·白王一一丨一
玩	sle·王元一一丿ㄋ
梦	mbo·林夕丿ㄋ丶丶
选	gr·先辶丶ㄋ丶丶
争	bou·争丿ㄋㄋ一一
疑	nvu·匕矢ㄋ丶ㄋ丨
既	tne·旡一ㄋ丿ㄋ
波	nz·氵皮ㄋ丿丨ㄋ
闪	fdo·门人丿丶丶丶
室	vg·宀至一ㄋ丶一
料	qw·米⺀一丨丨丨
简	lfi·门丨ㄋ一一
佛	jxo·亻弓丿丨丨丨
堂	cle·土一丨一一
索	bd·糸ㄋㄋ丶丨
规	jfi·夫见丨ㄋ丿ㄋ
朋	hho·月月丿ㄋ一一
攻	ln·工攵丿一丿丶
章	mp·音十一丨丨丨
礼	hpu·礻乚ㄋㄋㄋㄋ
鬼	soi·鬼丿丨ㄋ一一
春	lwi·日丨ㄋ一一
刘	nni·文刂丨丨丨丨
严	sjo·亚丿丿丿丿丿
赶	mne·走干一一丨丨
睡	bz·目垂丿一丨一
屋	zg·尸至一ㄋ丶一
食	po·食丿丶丶ㄋ一
饭	pau·饣ㄋ丶丶丶
济	nno·氵文丿丨丨丨
试	skei·讠弋一丨一一
仙	jyi·亻山丨ㄋ丨丨
导	gj·巳寸一丨丶丶
参	cwo·彡丿丿丿丿
沙	nvi·氵少丨丿丶丿
永	jtu·丶㇉ㄋ丿丶丶
肯	hhi·止⺝丨ㄋ一一
环	sheo·王不一丿丨丶
农	lru·农丶ㄋ丿ㄋ丿
恶	slr·亚心丶ㄋ丶丶
称	ca·禾尔丿ㄋ丨丿
止	hie·止丨一丨一一
初	hsu·衤刀ㄋ丿丿丿
医	vvo·匚矢丿一一丿
敌	nnoe·舌攵丿一丿丶
跳	zx·儿丶一丿丶
假	jqu·亻叚ㄋ一丨一
左	dlei·工一丨一一
散	ph·⺝丿一丿丶
温	nwi·氵日丨ㄋ丨丨
继	xq·纟米ㄋㄋㄋㄋ
换	gdi·扌丨ㄋ一丿
权	tfu·木又ㄋ丶丶丶
银	vhu·钅艮ㄋ一一ㄋ
君	ckiu·尹口丨ㄋ一一
退	hrr·艮辶丶ㄋ丶丶
闻	fye·门耳一丨丨一
激	ndr·氵白丶一ㄋ丿
画	jgu·一田ㄋ丨丨丨
较	yqo·车六丿丶丶丶
烈	bnr·歹刂丶丶丶丶
独	pb·犭虫丨ㄋ一丨
球	sw·王求一丨丶一
土	leiee·土一丨一一一
层	zm·尸云一一ㄋ丶
卫	wje·卩一一一一一
抱	gku·扌勹ㄋ一ㄋㄋ
草	fwe·艹日一丨丨丨
专	yt·二㇉丶丶丶丶
烟	pq·火因丨ㄋ一丿
余	qt·亼朩一丨丿丶
秋	cpr·禾火丶丿丿丶
顺	wneo·川页一丿丨ㄋ
顾	ag·厂一丿丨ㄋ
否	hki·不口丨ㄋ一一
值	jhe·亻直一丨丨ㄋ
考	fqe·耂与一ㄋㄋㄋ
冰	wni·冫水丨ㄋ丿丶
境	lm·土音丿ㄋㄋㄋ
妹	mde·女未丨丿丶丶
恐	la·工几丶丶ㄋ丶
怒	clr·奴心丶ㄋ丶丶
伯	jdoi·亻白丿丨ㄋ一
质	ap·十丨ㄋ丿丶
艺	fpu·艹乙ㄋㄋㄋㄋ
味	kde·口未丨丿丶丶
历	aw·厂力ㄋ丿丿丿
构	tku·木勹ㄋ丶丶丶
研	dne·石开一一丿丨
施	ddu·𭤨也ㄋ丨ㄋㄋ
贵	ldi·贝丨ㄋ丿丶
委	cm·禾女ㄋ丿一一
渐	ny·氵车丿丿一丨
淡	npr·氵火丶丿丿丶
史	kho·口乂丿丶丶丶
校	tqo·木六丿丶丶丶
狂	pse·犭王一一丨一
馆	pv·饣宀丨ㄋ一ㄋ
板	tau·木ㄋ丶丶丶
排	gzi·扌非丨一一一
价	jdoii·亻人丿丨丨丨
街	fhe·彳圭一一丨丨
宫	vki·宀口丨ㄋ一一
追	jhr·丿㠯丶ㄋ丶丶
靠	jzi·告非丨一一一
忍	sjru·刀丶丶ㄋ丶丶
普	aji·䒑业丨ㄋ一一
致	gnoe·至攵丿一丿丶
钟	vvi·钅中丨ㄋ一丨
娜	msu·女ㄋ丨丨丨
耳	yeii·耳一丨丨一一
属	zj·尸丿丨ㄋ一丨
忘	xlru·亡心丶ㄋ丶丶
苏	fwo·艹力丿丶丶丶
伙	jpr·亻火丶丿丿丶
仅	jfu·亻又ㄋ丶丶丶
景	wlr·日京丶一丨ㄋ
松	tc·木公丿丶ㄋ丶
州	wnr·川丶丶丶丶
胡	vho·古月丿ㄋ一一
纪	xgu·纟己ㄋ一ㄋㄋ
印	pj·一ㄋ丨丨丨
赵	mh·走乂丿丶丶丶
置	che·罒直一丨丨ㄋ
投	gdo·扌殳丿ㄋㄋ丶
列	bni·歹刂丨丨丨丨
隐	yx·阝刍丶ㄋ丶丶
缓	xye·纟爫一一丿ㄋ
座	afe·广从一丨一一
庄	ale·广土一丨一一
幸	lkr·土丶丿一一
副	lg·田丨丨丨丨
充	xxo·儿丿ㄋㄋㄋ
守	vjei·宀寸一丨丶丶
胜	hgo·月生丿一一丨
救	wno·求攵丿一丿丶
射	zje·身寸一丨丶丶
齐	nnoi·文丿丨丨丨
顶	ane·丁页一丿丨ㄋ
助	bw·且力ㄋ丿丿丿
右	dki·口丨ㄋ一一
素	xdu·糸ㄋㄋ丶丨
唐	as·广肀丨ㄋ一一
抓	gyo·扌爪丿丿丨丶
巨	vvu·匚ㄋ一一一
毛	woe·毛丿一一ㄋㄋ
诗	slei·讠土一丨丶丶
弄	sneo·王廾一丿丨丨
防	ym·阝方丶一ㄋ丿
雅	amo·牙隹丿丨丶一
源	nao·氵厂丿丨ㄋ一
户	tru·户丶ㄋ一丿丿
湖	nvo·氵古丿ㄋ一一
项	lne·工页一丿丨ㄋ
党	cx·儿丿ㄋㄋㄋ
压	alr·厂土丶丶丶丶
寒	hwr·寒⺀丶丶丶丶
效	qho·六乂丿一丿丶
奥	zq·米一丿丶丶
毫	gwo·毛丿一一ㄋ
增	lwr·土曾丶丿丨ㄋ
险	yqr·阝亼丶丶丿一
状	zpe·丬犬一丿丶丶
按	gv·扌宀ㄋ丿一一
买	twe·乛゛一丿丶丶
禁	mse·林示一一丨丿
阴	yh·阝月丿ㄋ一一
叹	kfu·口又ㄋ丶丶丶
蓝	fli·艹丨ㄋ丨丨
察	vye·宀一一丨丿
承	cpu·了三ㄋ丿丶丶
省	vb·少目丨ㄋ一一
份	jsor·亻分丿丶ㄋ丿
托	gje·扌丿一ㄋㄋㄋ
恩	qlru·因心丶ㄋ丶丶
责	xdi·贝丨ㄋ丿丶
挥	gqe·扌冖一ㄋ一丨
洛	nzo·氵各丿ㄋ丶丨
妇	mcu·女彐ㄋ一一一
牛	coe·牛丿一一丨丨
习	yu·习ㄋ丶一一一
警	dko·芍口丿一丿丶
默	xpe·黑犬一丿丶丶
岁	yb·山夕丿ㄋ丶丶
骑	ake·马大一丨ㄋ一
股	hdo·月殳丿ㄋㄋ丶
划	kni·戈刂丨丨丨丨
负	ddi·贝丨ㄋ丿丶
枪	td·木人ㄋㄋㄋㄋ
梅	tv·木ㄋㄋ丶一
采	yte·爫木一丨丿丶
吸	kso·口及丿ㄋ丶丶
富	vli·宀丨ㄋ一丨
舞	vf·卌丿ㄋ丶一
肉	ldo·内人丿丶丶丶
镇	vhor·钅直丿丶丶丶
野	ghu·里予ㄋ丶ㄋ丨
床	ate·广木一丨丿丶
某	dt·甘木一丨丿丶
醒	two·酉日丿一一丨
验	aq·马亼丶丶丿一
读	spu·讠十ㄋ丶丶一
担	gqi·扌旦丨ㄋ一一
毒	xv·母ㄋㄋ丶一
封	hj·圭寸一丨丶丶
尚	cs·冂丨ㄋ一一
纳	xli·纟内丨ㄋ丿丶
伊	jcu·亻尹ㄋ一一丿
营	wki·口丨ㄋ一一
猛	psi·犭子丨ㄋ丨丨
短	vhe·矢豆一丨ㄋ一
旧	jwi·丨日丨ㄋ一一
脱	hko·月𠮦丿ㄋㄋㄋ
遇	wlru·日⽱丶ㄋ丶丶
词	st·讠一丨ㄋ一
坏	lh·土不一丿丨丶
控	gde·扌穴一丨一一
田	giu·田丨ㄋ一丨一
乡	pjo·丿丿丿丿丿
刺	qni·朿刂丨丨丨丨
啦	kgr·口扌丶一丶丿
孙	sc·孑小丨丿丶丶
翻	mgu·釆田ㄋ丶一ㄋ
藏	fku·艹戊ㄋㄋㄋㄋ
虎	dao·虍几丿ㄋㄋㄋ
坚	mle·土一丨一一
良	jhu·丶艮ㄋ一一ㄋ
柔	hteio·矛木一丨丿丶
眉	zbi·目丨ㄋ一一
伸	jwii·亻日丨丨丨丨
窗	dzo·穴丿ㄋ丶一
咱	kjo·口自丿丨ㄋ一
婚	mmi·女氏丨ㄋ一一
戏	fke·又戈一ㄋ丿丶
逃	xnru·儿丶ㄋ丶丶
赛	hdiu·寒贝丨ㄋ丿丶
扬	gto·扌㇡丿丿丿丿
凡	ajr·几丶丶丶丶丶
凌	wlo·冫土丿丶丿ㄋ
配	tg·酉己ㄋ一ㄋㄋ
练	xyu·纟ㄋ丿丶丶
率	bpr·亠幺丶一丿丶
贝	di·贝丨ㄋ丿丶丶
宇	va·宀于一一丨丨
茶	fde·艹人一丨丿丶
优	jxr·亻尢丶丶丶丶
杰	tnr·木灬丶丶丶丶
吉	nei·吉一丨一丨ㄋ
卷	lgu·ㄋㄋㄋㄋ
创	dgi·人丨丨丨丨
罢	cwe·罒去一丨一ㄋ
秀	cwu·禾乃ㄋ丿丿丿
归	ncu·彐ㄋ一一一
哭	hpe·吅犬一丿丶丶
凤	afu·几又ㄋ丶丶丶
陆	yl·阝ㄋ丨丨丨
端	hye·立山一丿丨ㄋ
休	jte·亻木一丨丿丶
库	aye·广车一ㄋ一丨
序	ahu·广予ㄋ丶ㄋ丨
善	kai·羊䒑丨ㄋ一一
秘	clo·禾心丿丿丿丿
拍	gdoi·扌白丿丨ㄋ一
案	vme·宀女一丨丿丶
迷	qrr·米辶丶ㄋ丶丶
震	pye·辰一丿一一
免	wx·儿丿ㄋㄋㄋ
职	yk·耳口丿丶丶丶
洋	nkr·氵羊丶丿一一
寻	cje·彐寸一丨丶丶
养	kjoi·羊丶丿丨丨丨
珠	sje·王丿丨丿丶丶
歌	ggo·可可丿ㄋ丿丶
盘	pci·舟皿丨ㄋ丨丨
朱	jde·丿未丨丿丶丶
演	nve·氵宀一丨ㄋ一
虚	dji·虍业丨丨丶丿
呆	siu·呆丨ㄋ一一丨
付	jje·亻寸一丨丶丶
笔	lwo·毛丿一一ㄋ
适	nrr·舌辶丶ㄋ丶丶
康	ac·广丨丶一丿
麻	yre·麻丶一丿一丨
宁	vae·宀丁一丨丨丨
吴	kfe·口天一一丿丶
欲	fdi·八人丨ㄋ一丿
罪	cz·罒非丨一一一
恨	hhu·忄艮ㄋ一一ㄋ
杂	gte·九朩一丨丿丶
套	kbe·大镸一丨一一
骨	mi·骨丨ㄋㄋ丶ㄋ
紫	tdu·此糸ㄋㄋ丶丨
软	yao·车欠丿ㄋ丿丶
蒙	wjeo·一一丿ㄋ丿
弹	xhr·弓单丶丿丨ㄋ
育	xhi·⺝丨ㄋ一一
企	dhi·人止丨一丨一
仿	jmr·亻方丶一ㄋ丿
泪	nbi·氵目丨ㄋ一一
曲	aiu·曲丨ㄋ一丨丨
鱼	dou·鱼丿ㄋ丨ㄋ一
兽	wge·丷田一丨ㄋ一
略	gzo·田各丿ㄋ丶丨
握	gze·扌尸一ㄋ丶一
厅	aae·厂丁一丨丨丨
厉	awe·厂万一ㄋ丿丿
卖	pt·十乛丶丶一丿
供	jpe·亻共一丨丨一
丹	sb·冂亠丶一一一
喊	kkei·口戊一丨ㄋ一
峰	yn·山夂一一一丨
灯	pae·火丁一丨丨丨
绿	xci·纟丨丶一丿
夏	db·丆目丿ㄋ丶丶
塔	lfor·土艹丿丶一丨
桌	lwe·⺊日一丨丿丶
范	ygu·落ㄋㄋㄋㄋ
限	yhu·阝艮ㄋ一一ㄋ
县	bc·且厶ㄋ丶丶丶
讨	sjei·讠寸一丨丶丶
革	qe·革一丨丨一丨
燕	dkie·廿口丨一一丿
欧	mao·区欠丿ㄋ丿丶
临	nvr·丶丨ㄋ丨
移	cbo·禾夕丿ㄋ丶丶
洞	nse·氵冂一丨ㄋ一
剧	zvi·尸古丨丨丨丨
油	nai·氵由丨ㄋ一丨
束	ze·束一丨ㄋ一丨
替	jji·夫夫丨ㄋ一一
概	tte·木一ㄋ丿ㄋ
秦	lco·禾丿一丨丿
协	pwo·十力丿丶丶丶
材	ttei·木才一丨丿丿
魂	mso·云鬼丿丨ㄋ一
织	xko·纟口丿丶丶丶
智	vkiu·矢口丨ㄋ一一
诺	sfe·讠艹一丿丨ㄋ
爵	ycu·爫罒ㄋ一一ㄋ
丁	aei·丁一丨丨丨丨
劳	wwu·力ㄋ丿丿丿
律	fsu·彳聿ㄋ一一一
瞧	bm·目隹丶丶丶丶
丈	djr·丶丶丶丶丶
尊	dje·酋寸一丨丶丶
摆	gc·扌罒一丨一ㄋ
彩	yto·爫木丿丿丿丿
输	yqi·车亼丨ㄋ一一
败	dno·贝攵丿一丿丶
抬	gci·扌厶丨ㄋ一一
徐	fqei·彳亼一丨丿丶
熟	gso·孑丿ㄋ丶丶
森	tme·木林一丨丿丶
探	gqo·扌冖丿丶一丨
毕	mpe·比十一丨丨丨
预	hne·予页一丿丨ㄋ
雄	dc·厶丿丨丶一
测	ndi·氵贝丨丨丨丨
牙	aeu·牙一ㄋ丨丿丿
混	nwe·氵日一ㄋ丿ㄋ
升	jne·丿廾一丿丨丨
甲	aiue·甲丨ㄋ一一丨
祖	hbi·礻且丨ㄋ一一
瑞	syeo·王山一丿丨ㄋ
例	jbi·亻歹丨丨丨丨
迎	pwr·卩丶ㄋ丶丶
胸	hkor·月勹丿丶ㄋ丨
晓	wpeu·日尧一ㄋ丿一
透	cwr·禾乃丶ㄋ丶丶
鲁	dwi·鱼日丨ㄋ一一
架	tteio·加木一丨丿丶
纸	xmo·纟氏丿ㄋ一ㄋ
洗	ngo·氵先丿一丨一
浪	nju·氵丶ㄋ一一ㄋ
亦	preo·亦丶一丿丨丿
抗	gb·扌亠丿ㄋㄋㄋ
烦	pn·火页一丿丨ㄋ
班	snee·王一一丨一
盖	kci·皿丨ㄋ丨丨
宗	vse·宀示一一丨丿
塞	hlei·寒土一丨一一
登	yhe·癶豆一丨ㄋ一
墙	lp·土十丶丿一丨
闲	ft·门木一丨丿丶
烧	ppe·火尧一ㄋ丿一
硬	dbe·石更一丨ㄋ一
危	hgu·厃ㄋㄋㄋㄋ
肩	thi·户⺝丨ㄋ一一
午	vpe·十一丨丨丨
妙	mvi·女少丨丿丶丿
偷	jqi·亻亼丨ㄋ一一
互	jau·一彑ㄋㄋ一一
荣	wte·木一丨丿丶
含	qki·今口丨ㄋ一一
检	tqr·木亼丶丶丿一
执	dei·执一丨一丿ㄋ
菜	fyei·艹爫一丨丿丶
柳	tp·木卯丿ㄋ丿ㄋ
域	lki·土戈丨ㄋ一一
伦	jao·亻仑丿丶丿ㄋ
灭	jpro·一火丶丿丿丶
席	dyi·度巾丨ㄋ丨丨
莱	fwi·艹𰀆丨丿丶丶
编	xt·纟户丨ㄋ一丨
益	afi·䒑八丨ㄋ丨丨
呵	kgei·口可一丨ㄋ一
摸	gye·扌莫一丨丨丨
弱	xw·弓冫ㄋ一ㄋ丶
闹	fb·门亠丨ㄋ丨丨
徒	fme·彳走一丨一丨
述	tjru·木丶丶ㄋ丶丶
货	ydiu·化贝丨ㄋ丿丶
博	pfe·十甫一丨丶丶
劲	pwu·轻力ㄋ丿丿丿
宣	vji·宀一丨ㄋ一一
姓	mgo·女生丿一一丨
操	gki·扌口丨ㄋ一丨
获	fpe·艹犭一丿丶丶
懂	hfo·忄艹丿一丨丨
萧	fso·艹肀丿丨丿丶
蒂	fhi·艹丨ㄋ丨丨
著	ffe·艹者一丨一丿
妻	jsu·一肀ㄋ丿一一
鲜	dkr·鱼羊丶丿一一
旅	djo·𭤨丿ㄋ丿丶
敬	dkoe·芍口丿一丿丶
趣	my·走耳ㄋ丶丶丶
避	br·辟辶丶ㄋ丶丶
亡	xre·亡丶一ㄋㄋㄋ
释	mfee·釆又一一丨丨
积	cko·禾口丿丶丶丶
圆	kkiu·囗口丨ㄋ丿丶
杯	the·木不一丿丨丶
牌	kdo·片卑丿丨ㄋ一
批	gme·扌比一ㄋ丿ㄋ
阶	ydoi·阝人丿丨丨丨
爸	lgui·父巴ㄋ丨一ㄋ
占	tie·占丨一丨ㄋ一
拥	gtou·扌用丿ㄋ一一
辈	zy·非车一ㄋ一丨
困	ktei·囗木一丨丿丶
腿	hhr·月艮丶ㄋ丶丶
杜	tle·木土一丨一一
横	tpi·木丨ㄋ一丨
扑	glir·扌卜丨丶丶丶
抽	gai·扌由丨ㄋ一丨
羽	yur·羽ㄋ丶一ㄋ丶
借	jpi·亻龷丨ㄋ一一
妖	mfo·女夭丿一丿丶
征	fkei·彳正一丨一丨
莉	fc·艹禾丨丨丨丨
吓	kleir·口下一丨丶丶
策	lq·朿一丨ㄋ丨
犯	pgu·犭ㄋㄋㄋㄋ
袋	bjr·代衣丶一丿ㄋ
狠	phu·犭艮ㄋ一一ㄋ
骂	hau·吅马ㄋㄋ一一
曼	wc·日罒ㄋ丶丶丶
纷	xso·纟分丿丶ㄋ丿
虑	dlr·虍心丶ㄋ丶丶
婆	nzu·氵皮ㄋ丿一一
奶	mwu·女乃ㄋ丿丿丿
挂	ghe·扌圭一丨一一
拜	nje·一一一一丨
码	dau·石马ㄋㄋ一一
悲	zlru·非心丶ㄋ丶丶
佳	jhei·亻圭一丨一一
财	dte·贝才一丨丿丿
桥	tfo·木夭丿丨丨丨
盛	kti·戊丨ㄋ丨丨
怜	hqo·忄令丿丶丶ㄋ
奔	kpe·大十一丿丨丨
玛	sau·王马ㄋㄋ一一
勒	qwu·革力ㄋ丿丿丿
介	dnoi·人丿丨丨丨
厂	aeo·厂一丿丿丿丿
巧	lweu·工丂一ㄋㄋㄋ
狗	pk·犭勹丨ㄋ一一
尖	ckeo·小大一丿丶丶
勇	twu·甬力ㄋ丿丿丿
泰	lni·氺丨丶一丿
冒	wb·日目丨ㄋ一一
轮	yaor·车仑丿丶丿ㄋ
谷	fdiu·八人丨ㄋ一一
菲	fz·艹非丨一一一
孔	spuu·孑乚ㄋㄋㄋㄋ
庭	asu·广壬ㄋ丶丶丶
监	lci·皿丨ㄋ丨丨
伟	jjee·亻韦一一ㄋ丨
健	jsur·亻聿ㄋ丶丶丶
尤	xjr·尢丶丶丶丶丶
暴	wpi·日共丨丶一丿
络	xz·纟各丿ㄋ丶丨
丰	xe·丰一一一丨丨
餐	lbu·⺊夕ㄋ丶丿丶
唱	kwi·口日丨ㄋ一一
偏	jti·亻户丨ㄋ一丨
误	skee·讠口一一丿丶
哼	kgui·口ㄋ丨丨丨
飘	tsou·覀示丿ㄋ丿丶
岛	fyi·山丨ㄋ丨丨
凝	wnoe·冫匕丿一一丿
迪	arr·由辶丶ㄋ丶丶
萨	fyr·艹阝丶一丶丿
聚	yfo·耳又丿丨丿丿
惜	hpi·忄龷丨ㄋ一一
狼	pju·犭丶ㄋ一一ㄋ
诚	sku·讠戊ㄋㄋㄋㄋ
闭	fte·门才一丨丿丿
缘	xa·纟彑丿ㄋ丿丿
碰	dai·石䒑丨丨丶丿
迹	prr·亦辶丶ㄋ丶丶
折	meie·折一丨一丿丿
篇	lti·户丨ㄋ一丨
庆	akeo·广大一丿丶丶
洲	nwr·氵川丶丶丶丶
凯	ygo·山己丿ㄋㄋㄋ
残	bke·歹戋一一ㄋ丿
稳	cxr·禾刍丶ㄋ丶丶
鼓	apu·壴十ㄋ丶丶丶
腰	htu·月覀ㄋ丿一一
诸	sfei·讠者一丨一丿
韩	xje·韦一一ㄋ丨
版	kau·片ㄋ丶丶丶
附	yj·阝亻一丨丶丶
叔	lcu·上小ㄋ丶丶丶
沈	nqou·氵冖丿ㄋㄋㄋ
瓦	jeu·瓦一ㄋㄋ丶丶
唯	kmo·口隹丿丨丶一
降	yne·阝夂一ㄋ丨丨
挑	gx·扌儿丶一丿丶
镜	vmo·钅音丿ㄋㄋㄋ
访	smr·讠方丶一ㄋ丿
姆	mvu·女母ㄋㄋ丶一
舒	qv·亼古ㄋ丶ㄋ丨
犹	px·犭尢丶丶丶丶
补	hlir·衤卜丨丶丶丶
港	npu·氵共ㄋ一ㄋㄋ
幽	ypu·山幺ㄋㄋ丶丶
豪	gheo·豕一丿ㄋ丿
殿	zpo·尸共丿ㄋㄋ丶
宽	vfi·宀艹丨ㄋ丿ㄋ
郎	jtui·丶ㄋ丨丨丨
哦	kwoe·口我丿一丨一
评	sher·讠平一丶丿一
灰	dpr·火丶丿丿丶
缺	yvo·缶丿丶丶丶
玄	bpu·亠幺ㄋㄋ丶丶
厚	awu·厂日ㄋ丨一一
私	ccu·禾厶ㄋ丶丶丶
臂	bhi·辟⺝丨ㄋ一一
艾	fho·艹乂丿丶丶丶
谓	sgi·讠田丨ㄋ一一
妮	mz·女尸丿ㄋㄋㄋ
训	swo·讠川丿丨丨丨
舍	qve·亼古一丨丨ㄋ
遍	tlr·户丶ㄋ丶丶
孤	syo·孑瓜丿丿ㄋ丶
颜	hao·厂丿丿丿一
陪	yhi·阝立丨ㄋ一一
拳	lno·手丿一一丨
奋	kgi·大田丨ㄋ一丨
迟	krru·尺辶丶ㄋ丶丶
竹	loe·竹丿一丨丿一
仇	jgo·亻九丿ㄋㄋㄋ
稍	cci·禾丨ㄋ一一
遗	ldr·贝丶ㄋ丶丶
判	jni·半刂丨丨丨丨
戴	qge·田一丨丨一
讯	spe·讠一丨丨丨
汽	nvoe·氵气丿一一ㄋ
乔	fno·夭丿丨丨丨
疯	lao·疒几丿丶丶丶
壁	ble·辟土一丨一一
献	psr·十冂丶丿一一
芳	fmr·艹方丶一ㄋ丿
番	mgi·釆田丨ㄋ一丨
凭	jsou·亻壬丿ㄋㄋㄋ
胆	hqi·月旦丨ㄋ一一
琴	sso·王王丿丶丶ㄋ
尘	clei·小土一丨一一
挺	gsu·扌壬ㄋ丶丶丶
弃	xne·廾一丿丨丨
仁	jye·亻二一一一一
乌	ktee·勹㇉一一一一
碎	dbo·石亠丿丶丿丶
搞	ggi·扌丨ㄋ一一
录	cni·氺丨丶一丿
赞	ggiu·先先丨ㄋ丿丶
迅	ppr·十丶ㄋ丶丶
佩	jae·亻几一丨ㄋ丨
童	hgi·立里丨ㄋ一一
邪	ayu·牙阝ㄋ丨丨丨
择	gf·扌又一一丨丨
嘛	kyr·口麻丶一丿一
躲	za·身几一丨丿丶
朗	jto·丶丿ㄋ一一
宋	vt·宀木一丨丿丶
逐	hrru·豕辶丶ㄋ丶丶
忠	vlr·中心丶ㄋ丶丶
吹	kao·口欠丿ㄋ丿丶
摩	yno·麻手丿一一丨
幻	ptu·幺ㄋㄋㄋㄋ
朵	atei·几木一丨丿丶
欣	qa·斤欠丿ㄋ丿丶
抢	gdu·扌人ㄋㄋㄋㄋ
埃	lcoe·土厶丿一一丿
炼	pyu·火ㄋ丿丶丶
纯	xbe·纟屯一ㄋ丨ㄋ
典	afo·曲八丿丶丶丶
躺	zc·身丨ㄋ丨ㄋ
泽	nfee·氵又一一丨丨
针	vpei·钅十一丨丨丨
圈	klu·囗ㄋㄋㄋㄋ
皱	xzu·刍皮ㄋ丿丨ㄋ
糊	qvo·米古丿ㄋ一一
固	kve·囗古一丨丨ㄋ
锋	vne·钅夂一一一丨
乃	wuo·乃ㄋ丿丿丿丿
均	lkre·土勹丶一一一
凉	wlre·冫京丶一丨ㄋ
浮	nyu·氵爫ㄋ丨一一
触	hbiu·角虫丨ㄋ一丨
唇	yki·辰口丨ㄋ一一
页	neo·页一丿丨ㄋ丿
娇	mfoi·女夭丿丨丨丨
隔	yle·阝鬲一丨ㄋ一
纵	xf·纟从丿丶丿丶
绍	xsi·纟刀丨ㄋ一一
昨	wz·日乍丿一丨一
蛋	mbi·疋虫丨ㄋ一丨
侧	jdi·亻贝丨丨丨丨
悄	hci·忄丨ㄋ一一
荡	ytoo·落㇡丿丿丿丿
伴	jjro·亻半丶丿一一
箭	lar·前丶丿一丨
咬	kqo·口六丿丶丶丶
迫	dr·白辶丶ㄋ丶丶
累	gduu·田糸ㄋㄋ丶丨
傲	jke·亻敖一一丨一
扎	gpuu·扌乚ㄋㄋㄋㄋ
载	qye·车一ㄋ一丨
鸟	fou·鸟丿ㄋ丶ㄋㄋ
饰	pvi·饣丨ㄋ丨丨
腾	hlu·月ㄋㄋ一一
撞	ghi·扌立丨ㄋ一一
惨	hco·忄丿丿丿丿
猜	phe·犭青一一丨一
努	cwuo·奴力ㄋ丿丿丿
珍	sdoo·王人丿丿丿丿
尸	zue·尸ㄋ一丿丿丿
滚	nqu·氵六ㄋ丶丶丶
插	gnoi·扌千丿丨一ㄋ
氏	mo·氏丿ㄋ一ㄋㄋ
吻	kjou·口勿丿ㄋ丿丿
扫	gcu·扌彐ㄋ一一一
川	woi·川丿丨丨丨丨
丢	jwe·丿去一丨一ㄋ
抵	gmr·扌氏丶丶丶丶
减	wke·冫戊一丨ㄋ一
池	ndui·氵也ㄋ丨ㄋㄋ
彼	fzu·彳皮ㄋ丿丨ㄋ
莲	fyru·艹车丶ㄋ丶丶
票	tsee·覀示一一丨丿
伏	jpeo·亻犬一丿丶丶
粉	qs·米分丿丶ㄋ丿
昏	mwi·氏日丨ㄋ一一
刊	nnii·干刂丨丨丨丨
鼻	jgiu·自畀丨ㄋ一丨
阻	ybi·阝且丨ㄋ一一
臣	qei·臣一丨ㄋ一丨
梁	nso·氵刀丿丶一丨
奈	kse·大示一一丨丿
翼	yge·羽田一丨丨一
逼	lgr·田丶ㄋ丶丶
晶	wwi·日日丨ㄋ一一
嘿	kxi·口黑丨ㄋ丶丿
粗	qb·米且丨ㄋ一一
忆	hpuu·忄乙ㄋㄋㄋㄋ
弗	xno·弓丿丨丨丨
吐	kleie·口土一丨一一
盯	ba·目丁一丨丨丨
央	skeo·冂大一丿丶丶
曰	wiu·曰丨ㄋ一一一
麦	xnou·夂丿ㄋ丶丶
缩	xvo·纟宀丿丶丶丶
盟	whi·日月丨ㄋ丨丨
瞪	bye·目癶一丨ㄋ一
距	zvu·匚ㄋ一一一
芒	fxr·艹亡丶一ㄋㄋ
符	lje·亻一丨丶丶
堆	lmo·土隹丿丨丶一
忧	hxr·忄尢丶丶丶丶
鸡	ffo·又鸟丿ㄋ丶ㄋ
幕	yyiu·莫巾丨ㄋ丨丨
爆	pwe·火日一丨丨一
挡	gcue·扌ㄋ一一一
晨	wye·日辰一丿一一
颗	wteo·日木一丿丿丿
旋	dmu·𭤨疋ㄋ丨一丿
振	gyeo·扌辰一丿一一
净	wbo·冫争丿ㄋㄋ一
析	tqoo·木斤丿丿一丨
惯	hvi·忄毌丨ㄋ丿丶
赫	cce·赤赤丿丨丿丶
辛	nrer·辛丶一丶丿一
钢	vso·钅冂丿丶丶丶
敏	vvoe·母丿一丿丶
苍	fdu·艹人ㄋㄋㄋㄋ
描	gfi·扌艹丨ㄋ一丨
赏	cd·贝丨ㄋ丿丶
款	lso·士示丿ㄋ丿丶
凶	hsui·㐅凵ㄋ丨丨丨
颤	bx·亠回丨ㄋ一一
洁	nnei·氵吉一丨一丨
陷	ydoie·阝丿丨一ㄋ
损	gkiu·扌口丨ㄋ丿丶
汗	nnee·氵干一一丨丨
谋	sde·讠甘一丨丿丶
径	fpur·彳轻ㄋ丶一丨
夺	kjei·大寸一丨丶丶
鞋	qhei·革圭一丨一一
延	jhur·丿止ㄋ丶丶丶
莎	yvi·落少丨丿丶丿
漂	ntee·氵覀一一丨丿
抖	gwe·扌⺀一丨丨丨
遭	jai·一曲丨ㄋ一一
瞬	byo·目丿ㄋ丶一
坦	lqi·土旦丨ㄋ一一
愈	qhi·亼⺝丨丨丶ㄋ
椅	tkei·木大一丨ㄋ一
岸	yae·山厂一一丨丨
裂	bnre·歹刂丶一丿ㄋ
洪	npe·氵共一丨丨一
途	qtr·亼朩丶ㄋ丶丶
剩	czi·禾北丨丨丨丨
额	vze·宀各一丿丨ㄋ
销	vc·钅丨ㄋ一一
磨	yde·麻石一丿丨ㄋ
贴	dti·贝占丨一丨ㄋ
季	csu·禾子ㄋ丨一一
享	gsui·子ㄋ丨一一
赤	cei·赤丿丨丿丶丶
吟	kqor·口今丿丶丶ㄋ
愤	hpei·忄十一丨丨丨
醉	tb·酉亠丿丶丿丶
枝	tpu·木十ㄋ丶丶丶
慕	yci·莫丨丶丶丶
壮	zle·丬士一丨一一
隆	yneo·阝夂一丿一一
仔	jsui·亻子ㄋ丨一一
恢	hdr·忄丶丿丿丶
乘	czie·禾北丨一一丿
穷	dwu·穴力ㄋ丿丿丿
映	wse·日冂一丿丶丶
皆	mdo·比白丿丨ㄋ一
扶	gjee·扌夫一一丿丶
阁	fzo·门各丿ㄋ丶丨
俊	jcor·亻厶丿丶丿ㄋ
漫	nwiu·氵日丨ㄋ丨丨
祥	hkr·礻羊丶丿一一
桑	ffei·又双一丨丿丶
岂	ygue·山己ㄋ一ㄋㄋ
堡	jse·亻呆一丨一一
惑	kker·戈口一丶ㄋ丶
貌	ddo·豸白丿ㄋㄋㄋ
袭	ljr·龙衣丶一丿ㄋ
仰	jpu·亻ㄋ丨丨丨
嘉	atu·壴加ㄋ丿丨ㄋ
鸣	kfo·口鸟丿ㄋ丶ㄋ
邦	xyui·阝ㄋ丨丨丨
岳	qyi·丘山丨ㄋ丨丨
琳	sme·王林一丨丿丶
滑	nm·氵骨丨ㄋㄋ丶
跃	zf·夭丿一丿丶
宜	vbi·宀且丨ㄋ一一
俩	jfo·亻丙丿丶丿丶
毁	tlo·臼工丿ㄋㄋ丶
汇	nveu·氵匚一ㄋㄋㄋ
绕	xpeu·纟尧一ㄋ丿一
慧	xxu·丰丰ㄋ一一丶
逸	wxr·丶丶ㄋ丶
怨	bg·夕丶ㄋ丶丶
御	fvi·彳丨一丨一
唤	kdi·口丨ㄋ一丿
闷	flr·门心丶ㄋ丶丶
荒	fxo·艹亡丿丨ㄋㄋ
爬	ygui·爪巴ㄋ丨一ㄋ
厌	ape·厂犬一丿丶丶
傻	jzo·亻丿丶一丿
薄	yfe·落甫一丨丶丶
旗	dge·𭤨其一丨丨一
涌	ntu·氵甬ㄋ丶丨ㄋ
雾	pnu·夂ㄋ丿丿丿
羊	kro·羊丶丿一一一
吕	kkiue·口口丨ㄋ一一
仪	jnr·亻义丶丿丶丶
匆	jjrr·勿丶丶丶丶丶
泉	dni·白水丨ㄋ丿丶
拖	gvu·扌ㄋ丨ㄋㄋ
零	pqo·令丿丶丶ㄋ
孟	sci·子皿丨ㄋ丨丨
贼	dke·贝戈一丿丿丿
骗	ati·马户丨ㄋ一丨
辉	hqe·光冖一ㄋ一丨
尾	zw·尸毛丿一一ㄋ
恋	pl·亦心丶ㄋ丶丶
融	lbi·鬲虫丨ㄋ一丨
锁	vci·钅丨ㄋ丿丶
耐	yje·而寸一丨丶丶
核	thr·木亥丶一ㄋ丿
铺	vfe·钅甫一丨ㄋ一
炸	pzo·火乍丿一丨一
末	deei·一木一丨丿丶
拼	gae·扌䒑一丿丨丨
慌	hfr·忄艹丶一ㄋ丿
枫	tao·木几丿丶丶丶
启	tki·户口丨ㄋ一一
冬	nwrr·夂⺀丶丶丶丶
潮	nxo·氵丿ㄋ一一
甘	deii·甘一丨丨一一
帐	ybo·巾长丿一ㄋ丶
暂	yqiu·车斤丨ㄋ一一
睁	bbo·目争丿ㄋㄋ一
翠	ybor·羽亠丿丶丿丶
汤	nto·氵㇡丿丿丿丿
郑	aku·䒑大ㄋ丨丨丨
寂	vlio·宀上丨丿丶ㄋ
掩	gkiue·扌大丨ㄋ一一
宾	vq·宀丘丿丶丶丶
译	sfee·讠又一一丨丨
促	jkie·亻口丨一丿丶
递	xrr·弟辶丶ㄋ丶丶
踪	zve·宀一一丨丿
炮	pku·火勹ㄋ一ㄋㄋ
扩	gar·扌广丶一丿丿
旦	qiu·旦丨ㄋ一一一
倾	jneo·亻一丿丨ㄋ
垂	zoe·垂丿一丨一丨
侯	jvoe·亻丿一一丿
郭	gsuii·孑ㄋ丨丨丨
括	gnoei·扌舌丿一丨丨
审	vwi·宀日丨丨丨丨
督	lcur·上小ㄋ丶丨ㄋ
浓	nlr·氵农丶ㄋ丿ㄋ
匹	vxo·匚儿丿ㄋㄋㄋ
胖	hjr·月半丶丿一一
培	lhi·土立丨ㄋ一一
潜	njee·氵夫一一丿丶
嗯	kqr·口因丶ㄋ丶丶
宏	vd·宀ㄋ丶丶丶
戒	kne·戈廾一丿丨丨
尺	ku·尺ㄋ一丿丶丶
彻	fnu·彳七ㄋ丿丿丿
蛇	bv·虫宀丿ㄋㄋㄋ
擦	gvo·扌宀丿ㄋ丶丶
晃	whir·日光丨丶丿一
侍	jle·亻土一丨丶丶
羞	kaui·丑ㄋ丨一一
拔	gdur·扌ㄋ丶丶丶
慰	zs·尸示一丨丶丶
课	swe·讠日一丨丿丶
聊	ypo·耳卯丿ㄋ丿ㄋ
爹	lbo·父夕丿ㄋ丶丶
亿	jpuu·亻乙ㄋㄋㄋㄋ
疾	lvoe·疒矢丿一一丿
航	pbo·舟亠丿ㄋㄋㄋ
浑	nqe·氵冖一ㄋ一丨
绪	xfe·纟者一丨一丿
惠	jwie·一日丨一丶丶
舰	pfi·舟见丨ㄋ丿ㄋ
泥	nzou·氵尸丿ㄋㄋㄋ
狱	pseo·犭讠一丿丶丶
沿	naiu·氵几丨ㄋ一一
斜	qtrr·亼朩丶丶一丨
贸	pdiu·贝丨ㄋ丿丶
箱	lve·相一丨丿丶
奉	lle·一一丨丨
轰	yfur·车双ㄋ丶ㄋ丶
俗	jfor·亻八丿丶丨ㄋ
辞	nnr·舌辛丶一丶丿
劝	fwuo·又力ㄋ丿丿丿
拒	gvue·扌匚ㄋ一一一
鸿	nlo·氵工丿ㄋ丶ㄋ
墨	xle·黑土一丨一一
伍	jjei·亻五一丨ㄋ一
弯	pxu·亦弓ㄋ一ㄋㄋ
贫	sdi·分贝丨ㄋ丿丶
键	vsu·钅聿ㄋ丶丶丶
盗	pciu·次皿丨ㄋ丨丨
湾	npue·氵亦ㄋ一ㄋㄋ
浩	njo·氵告丿一丨一
吼	ksuu·口孑ㄋㄋㄋㄋ
颇	zne·皮页一丿丨ㄋ
奴	cuo·奴ㄋ丿一ㄋ丶
祝	hkou·礻口丿ㄋㄋㄋ
牧	cnoeo·牛攵丿一丿丶
授	gyu·扌ㄋ丶丶丶
愁	cpru·禾火丶ㄋ丶丶
霍	pm·隹丿丨丶一
俄	jwoe·亻我丿一丨一
侠	jwor·亻𰀆丿丶丶丶
帕	ydoiu·巾白丿丨ㄋ一
哀	gjo·丿ㄋ丿丶
抚	gjeo·扌一一丿ㄋㄋ
奖	zbe·丬夕一丿丶丶
疼	lnr·疒夂丶丶丶丶
耶	yyu·耳阝ㄋ丨丨丨
惧	hbo·忄丿丶丶丶
姊	mxo·女𠂔丿ㄋ丨丿
召	ski·刀口丨ㄋ一一
饮	pao·饣欠丿ㄋ丿丶
悉	mlr·釆心丶ㄋ丶丶
染	ngei·氵九一丨丿丶
卢	lzu·⺊尸ㄋ一丿丿
偶	jwiu·亻日丨ㄋ丨一
废	ax·广发ㄋ丿ㄋ丶
酸	tco·酉厶丿丶丿ㄋ
津	nsue·氵聿ㄋ一一一
扭	gau·扌丑ㄋ丨一一
辆	yfor·车丙丿丶丿丶
悠	jnru·攵丶ㄋ丶丶
碧	sdeo·王白一丿丨ㄋ
脉	hju·月丶ㄋㄋ丿丶
踏	zni·水丨ㄋ一一
撒	gpi·扌丨ㄋ一一
傅	jfe·亻甫一丨丶丶
黎	ckoo·禾勹丿丿丨丶
井	yeeo·井一一丿丨丨
挤	gnoii·扌文丿丨丨丨
询	skiu·讠勹丨ㄋ一一
愣	hcr·忄罒丶一ㄋ丿
讶	sae·讠牙一ㄋ丨丿
暖	wyee·日爫一一丿ㄋ
聪	ykr·耳𠮦丶ㄋ丶丶
夹	wd·𰀆人丿丶丶丶
赖	zd·束丨ㄋ丿丶
筑	llo·工丿ㄋ丶丶
炎	ppro·火火丶丿丿丶
予	hu·予ㄋ丶ㄋ丨丨
恼	hqre·忄㐫丶一丿丶
鹰	ajoi·广亻丿丨丶一
埋	lgi·土里丨ㄋ一一
嫁	mve·女宀一丿ㄋ丿
猫	pfiu·犭艹丨ㄋ一丨
仆	jli·亻卜丨丶丶丶
帽	ywi·巾日丨ㄋ一一
廷	srur·壬廴ㄋ丶丶丶
焦	mnr·隹灬丶丶丶丶
扯	ghie·扌止丨一丨一
敲	gkie·口丨一ㄋ丶
幅	yli·巾丨ㄋ一丨
虫	biue·虫丨ㄋ一丨一
瓶	aneu·䒑廾一ㄋㄋ丶
础	dyu·石屮ㄋ丨丨丨
冥	qwr·冖日丶一丿丶
仲	jvi·亻中丨ㄋ一丨
焰	pdo·火丿丨一ㄋ
倍	jhi·亻立丨ㄋ一一
岩	ydeo·山石一丿丨ㄋ
董	fni·艹千丨ㄋ一一
吞	fki·天口丨ㄋ一一
痕	lhu·疒艮ㄋ一一ㄋ
丧	pauo·十䒑ㄋ丿丶丶
曹	jaiu·一曲丨ㄋ一一
牢	vco·宀牛丿一一丨
甜	nde·舌甘一丨丨一
钻	vti·钅占丨一丨ㄋ
悔	hvu·忄ㄋㄋ丶一
昌	wwiu·日日丨ㄋ一一
肚	hleie·月土一丨一一
恰	hcor·忄合丿丶一丨
庞	aleo·广龙一丿ㄋ丿
粮	qju·米丶ㄋ一一ㄋ
屈	zyu·尸屮ㄋ丨丨丨
熊	cho·厶⺝丿ㄋ丿ㄋ
缠	xai·纟广丨ㄋ一一
赌	dfe·贝者一丨一丿
韦	jeeu·韦一一ㄋ丨丨
霞	pqu·叚ㄋ一丨一
璃	sqi·王㐫丨ㄋㄋ丶
膀	hhre·月丶一ㄋ丿
耀	hyo·光羽丿丨丶一
喷	kpei·口十一丨丨丨
挣	gbo·扌争丿ㄋㄋ一
寄	vkei·宀大一丨ㄋ一
溜	npi·氵丨ㄋ一丨
亭	gaei·丁一丨丨丨
泛	njr·氵丿丶ㄋ丶丶
罩	cli·罒⺊丨ㄋ一一
冠	qle·冖元一丨丶丶
遥	yyr·爫缶丶ㄋ丶丶
尝	cq·冖一一ㄋ丶
荷	pge·𦫻可一丨ㄋ一
瘦	ltiu·疒臼丨ㄋ丶丶
唉	kco·口厶丿一一丿
劫	wwuo·去力ㄋ丿丿丿
拾	gco·扌合丿丶一丨
欺	gaou·其欠丿ㄋ丿丶
恭	pcir·共丨丶丶丶
估	jve·亻古一丨丨ㄋ
梯	tx·木弟丶丿ㄋ一
锦	vdi·钅白丨ㄋ丨丨
艳	xdui·丰ㄋ丨一ㄋ
搭	gfo·扌艹丿丶一丨
辑	yke·车口一丨丨一
肃	sno·肀丿丶丶丶
帅	nyi·巾丨ㄋ丨丨
烂	paee·火䒑一一一一
锅	vkiuo·钅口丨ㄋ丿丶
俱	jbo·亻丿丶丶丶
浴	nfo·氵八丿丶丨ㄋ
桃	txr·木儿丶一丿丶
措	gpiu·扌龷丨ㄋ一一
昂	wpu·日ㄋ丨丨丨
搜	gti·扌臼丨ㄋ丶丶
姿	pmu·次女ㄋ丿一一
轩	ynee·车干一一丨丨
穴	drr·穴丶丶ㄋ丿丶
殊	bje·歹丿丨丿丶丶
郁	dhu·⺝ㄋ丨丨丨
铜	vsei·钅冂一丨ㄋ一
疗	lcui·疒了ㄋ丨丨丨
陵	ylo·阝土丿丶丿ㄋ
亏	ytu·二㇉ㄋㄋㄋㄋ
扰	gxr·扌尢丶丶丶丶
娃	mhe·女圭一丨一一
竞	hkouu·立口丿ㄋㄋㄋ
截	qmo·隹丿丨丶一
牵	kqoe·大冖丿一一丨
堪	lguu·土其ㄋㄋㄋㄋ
锐	vko·钅𠮦丿ㄋㄋㄋ
惹	fdiue·艹丨ㄋ一丶
悦	hkouuu·忄𠮦丿ㄋㄋㄋ
渡	ndur·氵度ㄋ丶丶丶
衫	hwo·衤彡丿丿丿丿
坡	lzuo·土皮ㄋ丿丨ㄋ
频	hce·止一丿丨ㄋ
税	ckou·禾𠮦丿ㄋㄋㄋ
抹	gdee·扌未丨丿丶丶
袍	hku·衤勹ㄋ一ㄋㄋ
宿	vjeo·宀亻一丿丨ㄋ
滴	nhi·氵丨ㄋ一丨
霸	pqou·革丿ㄋ一一
鹏	hhou·月月丿ㄋ丶ㄋ
忌	glr·己心丶ㄋ丶丶
喃	kpi·口十丨ㄋ丶丿
袖	hai·衤由丨ㄋ一丨
悟	hji·忄五丨ㄋ一一
柱	tkr·木主丶一一丨
陶	yko·阝勹丿一一丨
申	wjii·日丨丨丨丨丨
漠	nye·氵莫一丨丨丨
纹	xnre·纟文丶一丿丶
涂	nqei·氵亼一丨丿丶
迈	wrr·万辶丶ㄋ丶丶
跪	zhu·厃ㄋㄋㄋㄋ
繁	vvoeo·母丿一丿丶
燃	pbe·火一丿丶丶
寺	ljei·土寸一丨丶丶
驾	tauu·加马ㄋㄋ一一
搬	gpo·扌舟丿ㄋㄋ丶
勃	bs·子ㄋ丿丿丿
吾	jkiu·五口丨ㄋ一一
肥	hgui·月巴ㄋ丨一ㄋ
贤	mdi·贝丨ㄋ丿丶
怔	hke·忄正一丨一丨
允	cxo·厶儿丿ㄋㄋㄋ
链	vyr·钅车丶ㄋ丶丶
详	skr·讠羊丶丿一一
障	yme·阝音一丨丨丨
湿	nwii·氵日丨丨丶丿
寿	xjei·寸一丨丶丶
播	gmi·扌釆丨ㄋ一丨
缝	xnee·纟夂一一一丨
辰	yeo·辰一丿一一ㄋ
舌	noei·舌丿一丨丨ㄋ
喂	kgeu·口田一ㄋ丿丶
瑟	ssr·王王丶ㄋ丶丿
猎	ppi·犭龷丨ㄋ一一
啸	ksoi·口肀丿丨丿丶
扇	tyu·户羽ㄋ丶一ㄋ
储	jsei·亻讠一丨一丿
润	nfeei·氵门一一丨一
丛	fje·从一一一一一
函	cnu·了ㄋ丨丨丨
灾	vpr·宀火丶丿丿丶
慈	apuu·䒑幺ㄋㄋ丶丶
购	dku·贝勹ㄋ丶丶丶
戈	keu·戈一ㄋ丿丶丶
痴	lvi·疒矢丨ㄋ一一
返	afr·又丶ㄋ丶丶
浅	nke·氵戋一一ㄋ丿
晴	whe·日青一一丨一
卧	qli·臣卜丨丶丶丶
勾	kcu·勹厶ㄋ丶丶丶
玻	szu·王皮ㄋ丿丨ㄋ
卓	lwei·⺊日一丨丨丨
扔	gwuo·扌乃ㄋ丿丿丿
炉	ptr·火户丶ㄋ一丿
脆	hhuu·月厃ㄋㄋㄋㄋ
矮	vcu·矢禾ㄋ丿一一
喘	kye·口山一丿丨ㄋ
姜	kmu·女ㄋ丿一一
捉	gkieo·扌口丨一丿丶
抛	ggu·扌九ㄋ丿丿丿
葛	fwou·艹日丿ㄋ丿丶
扣	gkiuee·扌口丨ㄋ一一
盾	api·十丨ㄋ一一
勤	ywu·堇力ㄋ丿丿丿
霜	pve·相一丨丿丶
玲	sqo·王令丿丶丶ㄋ
恒	hjiu·忄一丨ㄋ一一
厨	ahe·厂豆一丨丶丶
冯	wa·冫马ㄋㄋ一一
躯	zvo·身匚丿丶丶丶
乖	nzi·千北丨一一丿
刑	nniii·开刂丨丨丨丨
芬	fsor·艹分丿丶ㄋ丿
侵	jcr·亻彐丶ㄋㄋ丶
薇	faou·艹丿ㄋㄋㄋ
扮	gsor·扌分丿丶ㄋ丿
狐	pyo·犭瓜丿丿ㄋ丶
丫	wjiii·丷丨丨丨丨丨
幼	pwuo·幺力ㄋ丿丿丿
耸	fyeii·从耳一丨丨一
捕	gfe·扌甫一丨ㄋ一
脏	hae·月广一丨一一
沟	nku·氵勹ㄋ丶丶丶
丑	aui·丑ㄋ丨一一一
签	lqr·亼丶丶丿一
仗	jdr·亻丶丶丶丶
茫	yxr·落亡丶一ㄋㄋ
辱	yjei·辰寸一丨丶丶
邓	fyu·又阝ㄋ丨丨丨
齿	hiei·齿丨一丨一丿
嘻	kaiu·口壴丨ㄋ一一
崇	yve·山宀一一丨丿
翔	kyu·羽ㄋ丶一ㄋ
斩	yqoo·车斤丿丿一丨
猪	pfei·犭者一丨一丿
笼	lleo·龙一丿ㄋ丿
糟	qji·米一丨ㄋ一丨
贯	vdiu·毌贝丨ㄋ丿丶
液	nbo·氵亠丿丶丿ㄋ
盈	wfi·乃又丨ㄋ丨丨
肤	hje·月夫一一丿丶
媚	mzi·女丨ㄋ一一
拦	gaee·扌䒑一一一一
屏	zae·尸䒑一丿丨丨
咒	haou·吅几丿ㄋㄋㄋ
拟	gbu·扌以ㄋ丶丿丶
涉	nhio·氵止丨丿丿丿
嫂	mti·女臼丨ㄋ丶丶
援	gyee·扌爫一一丿ㄋ
违	jrru·韦辶丶ㄋ丶丶
柏	tdo·木白丿丨ㄋ一
趁	mdoo·走人丿丿丿丿
僧	jwr·亻曾丶丿丨ㄋ
衡	fdiuei·彳丨ㄋ一丨
阔	fnoe·门氵丿一丨丨
摄	gyur·扌耳ㄋ丶ㄋ丶
瓜	yoo·瓜丿丿ㄋ丶丶
赢	ydiuo·赢贝丨ㄋ丿丶
矿	dar·石广丶一丿丿
裁	qjr·衣丶一丿ㄋ
刹	htii·乂朩丨丨丨丨
疲	lzuoi·疒皮ㄋ丿丨ㄋ
柯	tge·木可一丨ㄋ一
豫	hwou·予象丿ㄋ丨ㄋ
晕	wqe·日冖一ㄋ一丨
溪	nyuu·氵爫ㄋㄋ丶一
币	jyiu·丿巾丨ㄋ丨丨
淑	nli·氵上丨丿丶ㄋ
贺	tdi·加贝丨ㄋ丿丶
弓	xue·弓ㄋ一ㄋㄋㄋ
勉	wxu·ㄋ丿丿丿
桂	thei·木圭一丨一一
懒	hzo·忄束丿ㄋ丨ㄋ
雕	snoi·冂吉丿丨丶一
巡	wrru·巛辶丶ㄋ丶丶
庙	aai·广由丨ㄋ一丨
碗	dvo·石宀丿ㄋ丶ㄋ
铃	vqo·钅令丿丶丶ㄋ
裤	haeu·衤广一ㄋ一丨
挨	gcoe·扌厶丿一一丿
掠	glre·扌京丶一丨ㄋ
豆	heiu·豆一丨ㄋ一丶
寸	jeir·寸一丨丶丶丶
誉	mfr·八丶一一一
串	kvi·口中丨ㄋ一丨
割	vxiu·宀丰丨ㄋ一丨
腹	hviu·月丨ㄋ一一
驱	ame·马区一丿丶ㄋ
奏	lfe·天一一丿丶
甫	feiu·甫一丨ㄋ一一
植	theii·木直一丨丨ㄋ
诱	scu·讠禾ㄋ丿丿丿
订	saei·讠丁一丨丨丨
蕾	fpi·艹丨ㄋ一丨
罚	csi·罒讠丨丨丨丨
披	gzu·扌皮ㄋ丿丨ㄋ
覆	tfoe·覀彳丿一丨ㄋ
悬	bcr·且厶丶ㄋ丶丶
涛	nxe·氵一丨丶丶
眨	bjru·目丿丶ㄋ丶丶
柜	tvu·木匚ㄋ一一一
矩	vvue·矢匚ㄋ一一一
欠	aouo·欠丿ㄋ丿丶丶
怖	hdiui·忄丨ㄋ丨丨
棋	tgei·木其一丨丨一
贾	tdiu·覀贝丨ㄋ丿丶
穆	cdi·禾白丨丿丶丿
姬	mq·女一丨丨ㄋ
柄	tfor·木丙丿丶丶丶
饿	pwoe·饣我丿一丨一
琪	sge·王其一丨丨一
邻	qyu·令阝ㄋ丨丨丨
姨	mku·女大ㄋ一ㄋㄋ
驻	akre·马主丶一一丨
愧	hsoi·忄鬼丿丨ㄋ一
爽	khor·大乂丿丶丿丶
跌	zjee·丿一一丿丶
弥	xao·弓尔丿ㄋ丨丿
污	nyuuu·氵二ㄋㄋㄋㄋ
崔	ymo·山隹丿丨丶一
臭	jpeor·自犬一丿丶丶
苑	fbu·艹夕ㄋㄋㄋㄋ
捷	gju·扌一ㄋ一一丨
摘	ghiu·扌丨ㄋ一丨
吵	kvio·口少丨丿丶丿
辩	nsr·辛讠丶一丶丿
魏	cmo·禾女丿丨ㄋ一
咐	kjeir·口亻一丨丶丶
慎	hhor·忄直丿丶丶丶
昆	wme·日比一ㄋ丿ㄋ
誓	msr·折言丶一一一
凑	wle·冫一一丿丶
袁	njou·吉丿ㄋ丿丶
撤	gxi·扌丨ㄋ一一
劈	bsu·辟刀ㄋ丿丿丿
蛮	pbi·亦虫丨ㄋ一丨
卿	pjue·丿ㄋ一一ㄋ
歇	wkor·日勹丿丶ㄋ丿
添	nfi·氵天丨丶丶丶
牲	cg·牜生丿一一丨
售	mki·隹口丨ㄋ一一
祭	ysee·示一一丨丿
纤	xnoe·纟千丿一丨丨
咖	ktu·口加ㄋ丿丨ㄋ
脖	hbu·月ㄋ丨一一
沃	nfoe·氵夭丿一丿丶
廊	aju·广丶ㄋ一一ㄋ
租	cbi·禾且丨ㄋ一一
撑	gcoee·扌丿一一丨
岗	ysor·山冂丿丶丶丶
嚷	kbiu·口亠丨ㄋ一丨
肖	chi·⺝丨ㄋ一一
旺	wsee·日王一一丨一
坊	lmr·土方丶一ㄋ丿
哎	kfor·口艹丿丶丶丶
拨	gxu·扌发ㄋ丿ㄋ丶
酷	tjo·酉告丿一丨一
乏	jkr·丿之丶ㄋ丶丶
稀	cheo·禾乂一丿丨ㄋ
烤	pfeu·火耂一ㄋㄋㄋ
佣	jtou·亻用丿ㄋ一一
踢	zwo·日丿ㄋ丿丿
碍	dq·石旦一丨丶丶
宅	vjeu·宀丿一ㄋㄋㄋ
祸	hkiu·礻口丨ㄋ丿丶
啡	kzie·口非丨一一一
跨	zke·大一一ㄋㄋ
坛	lme·土云一一ㄋ丶
凄	wju·冫一ㄋ一一丨
综	xve·纟宀一一丨丿
眸	bco·目厶丿一一丨
谅	slre·讠京丶一丨ㄋ
虹	blei·虫工一丨一一
渊	nnro·氵丶丿一丨
愉	hqiu·忄亼丨ㄋ一一
刃	sjrr·刀丶丶丶丶丶
械	tkeo·木戈一丿丨丨
催	jyo·亻山丿丨丶一
鞭	qje·革亻一丨ㄋ一
邀	dmo·白方丿一丿丶
届	zai·尸由丨ㄋ一丨
肠	hto·月㇡丿丿丿丿
兼	yro·兼丶丿一ㄋ一
洒	ntei·氵西一丨ㄋ丿
娶	yfuo·耳又ㄋ丿一一
绳	xki·纟口丨ㄋ一一
鼠	toi·鼠丿丨一ㄋ一
墓	ylei·莫土一丨一一
巾	yiu·巾丨ㄋ丨丨丨
哲	mkiu·折口丨ㄋ一一
耗	dwo·耒毛丿一一ㄋ
赐	dwou·贝日丿ㄋ丿丿
胁	hwor·月力丿丶丶丶
婉	mvo·女宀丿ㄋ丶ㄋ
遮	dnru·度灬丶ㄋ丶丶
窝	dkiu·穴口丨ㄋ丿丶
夸	kyuu·大二ㄋㄋㄋㄋ
逢	nxr·夂丰丶ㄋ丶丶
泄	nduu·氵廿ㄋㄋㄋㄋ
砍	daou·石欠丿ㄋ丿丶
摔	gbuu·扌亠ㄋㄋ丶丶
蝶	bdu·虫廿ㄋ一丨丿
矛	hur·矛ㄋ丶ㄋ丨丿
龄	hqor·齿令丿丶丶ㄋ
屁	zme·尸比一ㄋ丿ㄋ
岭	yqor·山令丿丶丶ㄋ
韵	mkr·音勹丶一一一
夕	bour·夕丿ㄋ丶丶丶
媒	mdei·女甘一丨丿丶
卑	doiu·卑丿丨ㄋ一一
愚	wlrur·日⽱丶ㄋ丶丶
湘	nvei·氵相一丨丿丶
驶	ako·马口丿丶丶丶
歉	yaou·兼欠丿ㄋ丿丶
疏	thre·乛止丶一ㄋ丶
咽	kqi·口因丨ㄋ一丿
丘	qoi·丘丿丨一丨一
矣	cvo·厶矢丿一一丿
叛	jaur·半ㄋ丶丶丶
巫	lforo·工从丿丶丿丶
兹	apuur·䒑幺ㄋㄋ丶丶
蜜	vloi·宀心丿丨ㄋ一
娅	msei·女亚一丨丨丶
饶	ppeu·饣尧一ㄋ丿一
狄	pproo·犭火丶丿丿丶
漆	ntor·氵木丿丶丶丶
腐	ajei·广亻一丨丶丨
辣	nze·辛束一丨ㄋ一
笨	lte·木一一一一
奸	mnee·女干一一丨丨
嫌	myr·女兼丶丿一ㄋ
僵	jjiu·亻一丨ㄋ一丨
逻	cbr·罒夕丶ㄋ丶丶
吊	kyi·口巾丨ㄋ丨丨
脾	hdoi·月卑丿丨ㄋ一
仓	dgu·人ㄋㄋㄋㄋ
舟	poo·舟丿丿ㄋ丶一
胶	hqorr·月六丿丶丶丶
囊	bhee·吅一一丨丨
逆	srr·屰辶丶ㄋ丶丶
寓	vwiu·宀日丨ㄋ丨一
挖	gduuu·扌穴ㄋㄋㄋㄋ
宴	vwu·宀日ㄋ丿一一
刷	zyi·尸巾丨丨丨丨
孝	fsui·耂子ㄋ丨一一
乾	xvu·ㄋㄋㄋㄋ
肌	haouu·月几丿ㄋㄋㄋ
捏	gwei·扌日一丨一一
屠	zfe·尸者一丨一丿
患	kvr·口中丶ㄋ丶丶
尉	zse·尸示一丨丶丶
驰	adu·马也ㄋ丨ㄋㄋ
翁	cyu·公羽ㄋ丶一ㄋ
闯	fau·门马ㄋㄋ一一
滋	nau·氵䒑ㄋㄋ丶ㄋ
贪	qd·今贝丨ㄋ丿丶
骇	ahr·马亥丶一ㄋ丿
纱	xvi·纟少丨丿丶丿
泡	nkue·氵勹ㄋ一ㄋㄋ
迁	nrru·千辶丶ㄋ丶丶
鹤	qmou·冖隹丿ㄋ丶ㄋ
芙	fjee·艹夫一一丿丶
耻	yhie·耳止丨一丨一
邮	ayui·由阝ㄋ丨丨丨
饱	pkue·饣勹ㄋ一ㄋㄋ
捧	glee·扌一一丨丨
裙	hciu·衤尹丨ㄋ一一
叉	fjr·又丶丶丶丶丶
黛	bxi·代黑丨ㄋ丶丿
搂	gqu·扌米ㄋ丿一一
煞	xnrr·刍攵丶丶丶丶
哩	kgiu·口里丨ㄋ一一
循	fae·彳一丨丨ㄋ
筋	lhuo·月ㄋ丿丿丿
砸	dvi·石匚丨ㄋ丨丨
廉	ayr·广兼丶丿一ㄋ
陛	ymei·阝比一丨一一
档	tcu·木ㄋ一一一
盒	cciu·合皿丨ㄋ丨丨
艰	fhu·又艮ㄋ一一ㄋ
剪	asuo·前刀ㄋ丿丿丿
债	jxi·亻丨ㄋ丿丶
役	fdou·彳殳丿ㄋㄋ丶
绵	xdiu·纟白丨ㄋ丨丨
膝	htor·月木丿丶丨丶
抑	gpui·扌ㄋ丨丨丨
畏	gjuo·田一ㄋ丿丶丶
棒	tlee·木一一丨丨
呈	ksee·口王一一丨一
厦	adiu·厂丆丨ㄋ一一
吩	ksor·口分丿丶ㄋ丿
渴	nwou·氵日丿ㄋ丿丶
嘲	kxo·口丿ㄋ一一
绩	xxi·纟丨ㄋ丿丶
励	awuo·厂万ㄋ丿丿丿
灌	nfiu·氵艹丨ㄋ一丨
乳	ysu·爫子ㄋㄋㄋㄋ
爪	yooi·爪丿丿丨丶丶
杖	tdr·木丶丶丶丶
蠢	lwiu·日丨ㄋ一丨
盼	bso·目分丿丶ㄋ丿
籍	lde·耒一丨丨一
妥	ymu·爫女ㄋ丿一一
卜	lir·卜丨丶丶丶丶
舅	tgu·臼田ㄋ丿丿丿
颊	wde·𰀆人一丿丨ㄋ
敦	gsoe·孑丿一丿丶
喉	kjue·口亻ㄋ一丿一
苗	fg·艹田丨ㄋ一丨
咳	khr·口亥丶一ㄋ丿
栏	tae·木䒑一一一一
帘	dyiu·穴巾丨ㄋ丨丨
颈	pne·轻页一丿丨ㄋ
拓	gdeo·扌石一丿丨ㄋ
汪	nsee·氵王一一丨一
秒	cvi·禾少丨丿丶丿
瞒	bfe·目艹一丨ㄋ丿
杆	tnee·木干一一丨丨
宙	vai·宀由丨ㄋ一丨
览	lfiu·见丨ㄋ丿ㄋ
寨	hteior·寒朩一丨丿丶
契	xse·丰刀一丿丶丶
掏	gko·扌勹丿一一丨
址	lhie·土止丨一丨一
翰	xdur·人ㄋ丶一ㄋ
彭	awo·壴彡丿丿丿丿
毅	hhouu·立𧰨丿ㄋㄋ丶
惟	hmo·忄隹丿丨丶一
稿	cgi·禾丨ㄋ一一
棉	tdiui·木白丨ㄋ丨丨
潘	nmi·氵釆丨ㄋ一丨
妨	mmr·女方丶一ㄋ丿
漏	nzei·氵尸一丨ㄋ丨
纠	xbu·纟丩ㄋ丨丨丨
谨	syei·讠堇一丨丨一
柴	tteior·此木一丨丿丶
琼	slrei·王京丶一丨ㄋ
珊	ssou·王冂丿ㄋ一一
乙	pu·乙ㄋㄋㄋㄋㄋ
裹	bwe·亠日一丨丿丶
宠	vleo·宀龙一丿ㄋ丿
塑	shei·屰月一丨一一
盆	sciu·分皿丨ㄋ丨丨
殷	acu·彐ㄋ丿ㄋㄋ
崖	yaei·山厂一丨一一
署	cf·罒者一丨一丿
枯	tve·木古一丨丨ㄋ
狮	pnei·犭一丨ㄋ丨
霄	pciue·丨ㄋ一一
纽	xau·纟丑ㄋ丨一一
枚	tno·木攵丿一丿丶
莹	wsr·王丶丶丶丶
巷	pgue·共巳ㄋ一ㄋㄋ
剂	nniiii·文丨丨丨丨
戚	kli·戊上丨丿丶丶
遂	whr·丷豕丶ㄋ丶丶
挽	gwou·扌丿ㄋㄋㄋ
哑	ksei·口亚一丨丨丶
瑶	syoe·王爫丿一一丨
涨	nxoe·氵弓丿一ㄋ丶
贡	ldiu·工贝丨ㄋ丿丶
筹	lxe·一丨丶丶
册	sse·冂冂一一一一
晋	swi·亚日丨ㄋ一一
衬	hjei·衤寸一丨丶丶
斥	qjrr·斤丶丶丶丶丶
魄	dso·白鬼丿丨ㄋ一
腔	hde·月穴一丨一一
陌	yjo·阝一丿丨ㄋ一
牺	ct·牜西一丨ㄋ丿
阅	fko·门𠮦丿ㄋㄋㄋ
婴	dduo·贝贝ㄋ丿一一
蔡	fyee·艹一一丨丿
芝	fkru·艹之丶ㄋ丶丶
艘	pti·舟臼丨ㄋ丶丶
雀	cmoi·小隹丿丨丶一
氛	vsor·气分丿丶ㄋ丿
鉴	lvor·金丿丶一一
粒	qhr·米立丶一丶丿
甩	hpuuu·月乚ㄋㄋㄋㄋ
腕	hvo·月宀丿ㄋ丶ㄋ
绘	xde·纟人一一ㄋ丶
姚	mxr·女儿丶一丿丶
撕	ggoo·扌其丿丿一丨
藤	fhr·艹月丶丿一一
胞	hkue·月勹ㄋ一ㄋㄋ
咕	kvei·口古一丨丨ㄋ
昭	wsi·日刀丨ㄋ一一
谎	sfr·讠艹丶一ㄋ丿
婷	mge·女一丨丨丨
辨	nnre·辛丶一丶丿
糖	qau·米广ㄋ一一丨
贞	ldiuo·⺊贝丨ㄋ丿丶
棍	tweu·木日一ㄋ丿ㄋ
倘	jciu·亻丨ㄋ丨ㄋ
谦	syr·讠兼丶丿一ㄋ
魅	sdee·鬼未丨丿丶丶
麟	mqo·鹿米丿ㄋ丶一
逊	scr·孑小丶ㄋ丶丶
骄	afoi·马夭丿丨丨丨
歪	hkei·不正一丨一丨
诡	shu·讠厃ㄋㄋㄋㄋ
伪	jju·亻丶ㄋ丿丶丶
蓉	fdor·艹穴丿丶丨ㄋ
鼎	bki·目丨一丨ㄋ
蓬	fne·艹夂一一一丨
钉	vaei·钅丁一丨丨丨
郡	cku·尹口ㄋ丨丨丨
妃	mgue·女己ㄋ一ㄋㄋ
薛	fji·艹丿丨ㄋ一ㄋ
冻	wyi·冫丨丿丶丶
骤	ayur·马耳ㄋ丶丿丨
沾	nti·氵占丨一丨ㄋ
塘	lau·土广ㄋ一一丨
斤	qoo·斤丿丿一丨丨
馨	lzo·士丿ㄋㄋ丶
叠	ffr·又双丶ㄋ丨ㄋ
赴	mli·走卜丨丶丶丶
疆	xlei·弓土一丨ㄋ一
伐	jkeu·亻戈一ㄋ丿丶
眠	bq·目民ㄋ一ㄋ一
禅	hhro·礻单丶丿丨ㄋ
渔	ndo·氵鱼丿ㄋ丨ㄋ
赋	djeu·贝一一ㄋ丶丨
慨	hteu·忄一ㄋ丿ㄋ
削	chii·⺝丨丨丨丨
辽	cr·了辶丶ㄋ丶丶
赚	dyr·贝兼丶丿一ㄋ
拐	gkuo·扌口ㄋ丿丿丿
澳	nzr·氵丶丿一丨
哇	khe·口圭一丨一一
揭	gwouo·扌日丿ㄋ丿丶
鑫	vvor·金金丿丶一一
偿	jcru·亻丶ㄋ一一
倦	jlu·亻ㄋㄋㄋㄋ
玫	snoe·王攵丿一丿丶
竭	hwouo·立日丿ㄋ丿丶
枕	tqou·木冖丿ㄋㄋㄋ
雁	ajoir·厂亻丿丨丶一
菊	dqr·芍米丶丿一丨
耍	ymuo·而女ㄋ丿一一
倩	jhee·亻青一一丨一
烛	pbiu·火虫丨ㄋ一丨
昔	pwi·龷日丨ㄋ一一
泣	nhr·氵立丶一丶丿
遵	djru·酋寸丶ㄋ丶丶
胳	hzou·月各丿ㄋ丶丨
谊	svi·讠宀丨ㄋ一一
辅	yfei·车甫一丨ㄋ一
叙	qtu·亼朩ㄋ丶丶丶
绣	xcu·纟禾ㄋ丿丿丿
涯	nae·氵厂一丨一一
鹿	mreo·鹿丶一丿ㄋ丨
噢	kzr·口丶丿一丨
俏	jciue·亻丨ㄋ一一
寇	vlie·宀元丨一ㄋ丶
摊	gfoi·扌又丿丨丶一
翅	pfur·十又ㄋ丶一ㄋ
症	lke·疒正一丨一丨
瞥	qniu·㡀攵丨ㄋ一一
宛	vbu·宀夕ㄋㄋㄋㄋ
呜	kku·口勹ㄋ一一一
逗	hrrur·豆辶丶ㄋ丶丶
糕	qkr·米羊丶丶丶丶
畅	wjuo·日丨ㄋ丿丿丿
趋	mxou·走刍丿ㄋㄋ一
朴	tli·木卜丨丶丶丶
泼	nxu·氵发ㄋ丿ㄋ丶
账	dboe·贝长丿一ㄋ丶
俯	jaor·亻广丿丶一丨
逝	mrru·折辶丶ㄋ丶丶
葬	fbo·艹歹丿ㄋ一丿
讽	sao·讠几丿丶丶丶
祈	hqoo·礻斤丿丿一丨
衰	gjou·一丿ㄋ丿丶
樱	tdiuo·木贝丨ㄋ丿丶
拆	mjr·折丶丶丶丶丶
妄	xmu·亡女ㄋ丿一一
饼	paeo·饣䒑一丿丨丨
筒	lse·冂一丨ㄋ一
豹	dkrr·豸勹丶丶丶丶
揉	ghei·扌矛一丨丿丶
蓄	fbuu·艹亠ㄋㄋ丶丶
趟	mci·走丨ㄋ丨ㄋ
诊	sdooo·讠人丿丿丿丿
押	gaiu·扌甲丨ㄋ一一
镖	vte·钅覀一一丨丿
嗓	kfur·口又ㄋ丶ㄋ丶
绑	xxui·纟ㄋ丨丨丨
淋	nme·氵林一丨丿丶
愕	hhee·忄吅一一ㄋㄋ
倚	jkei·亻大一丨ㄋ一
蜂	bnee·虫夂一一一丨
滨	nvoi·氵宀丿丨一丨
寞	vyei·宀莫一丨丨丨
裸	hwe·衤日一丨丿丶
尹	cue·尹ㄋ一一丿丿
弦	xbuu·弓亠ㄋㄋ丶丶
坑	lbou·土亠丿ㄋㄋㄋ
滩	nfoi·氵又丿丨丶一
儒	jpeoi·亻一丿丨ㄋ
谱	sai·讠䒑丨丨丶丿
骚	afri·马又丶丨ㄋ一
朕	haeo·月䒑一丿丶丶
胎	hciue·月厶丨ㄋ一一
淫	nyo·氵爫丿一丨一
竖	mhr·立丶一丶丿
蒋	fzou·艹丬丿ㄋ丶丶
恍	hhir·忄光丨丶丿一
哄	kpeii·口共一丨丨一
鄙	kpiu·口十丨ㄋ丨ㄋ
嫩	mzo·女束丿一丿丶
舱	pdu·舟人ㄋㄋㄋㄋ
践	zkee·戋一一ㄋ丿
劣	vwuo·少力ㄋ丿丿丿
萍	yher·落平一丶丿一
遣	lhr·㠯丶ㄋ丶丶
佐	jdei·亻一丨一一
荆	fnii·艹开丨丨丨丨
祷	hxe·衤一丨丶丶
壶	bji·业丨丨丶丿
麽	yju·麻丿ㄋ丶丶丶
膊	hfei·月甫一丨丶丶
煤	pde·火甘一丨丿丶
冤	qwo·冖丿ㄋ丶丶
兮	fweu·八丂一ㄋㄋㄋ
寡	vdiue·宀丆丨ㄋ一一
斑	sneei·王文一一丨一
窜	dkiue·穴口丨ㄋ一丨
颠	hfeo·直八一丿丨ㄋ
拱	gpe·扌共一丨丨一
坠	ydei·阝人一丨一一
搁	gfou·扌门丿ㄋ丶丨
茨	fpr·艹次丶一丿ㄋ
惶	hdee·忄白一一丨一
磁	dauu·石䒑ㄋㄋ丶ㄋ
妆	zmu·丬女ㄋ丿一一
暮	ywiu·莫日丨ㄋ一一
拂	gxo·扌弓丿丨丨丨
匠	vqoo·匚斤丿丿一丨
怡	hciuee·忄厶丨ㄋ一一
晰	wto·日木丿丿一丨
峡	ywo·山𰀆丿丶丶丶
焉	kqrr·正与丶丶丶丶
杭	tbo·木亠丿ㄋㄋㄋ
旨	nwiue·匕日丨ㄋ一一
轿	yfoi·车夭丿丨丨丨
瑰	ssoi·王鬼丿丨ㄋ一
顽	lneo·元页一丿丨ㄋ
瞎	bve·目宀一一一丨
猴	pjueo·犭亻ㄋ一丿一
兆	xnreo·儿丶一丿丶
躬	zxu·身弓ㄋ一ㄋㄋ
裕	hfor·衤八丿丶丨ㄋ
踩	zye·爫一丨丿丶
盐	lliu·土卜丨ㄋ丨丨
填	lho·土直丿丶丶丶
轴	yai·车由丨ㄋ一丨
夷	kxu·大弓ㄋ一ㄋㄋ
斧	lqo·父斤丿丿一丨
涵	ncr·氵了丶一丿丶
哟	kxou·口纟丿ㄋ丶丶
屑	zci·尸丨ㄋ一一
晌	wzi·日丨ㄋ一一
帆	yar·巾几丶丶丶丶
刮	nniiii·舌刂丨丨丨丨
篷	lnee·夂一一一丨
攀	tho·木乂丿丶一丨
坤	lwii·土日丨丨丨丨
怯	hwei·忄去一丨一ㄋ
谭	sti·讠覀丨ㄋ一一
腊	hpiu·月龷丨ㄋ一一
厢	ave·厂相一丨丿丶
钦	vao·钅欠丿ㄋ丿丶
铭	vbiu·钅夕丨ㄋ一一
宰	vnr·宀辛丶一丶丿
篮	lliui·丨ㄋ丨丨
陀	yvou·阝宀丿ㄋㄋㄋ
仑	aor·仑丿丶丿ㄋㄋ
兔	wxrr·丶丶丶丶
烁	ppio·火丨丿丶丶
匪	vzi·匚非丨一一一
桐	tsei·木冂一丨ㄋ一
剥	cnii·氺丨丨丨丨
堵	lfei·土者一丨一丿
俞	qhii·亼⺝丨丨丨丨
棵	twei·木日一丨丿丶
贱	dkee·贝戋一一ㄋ丿
妒	mtr·女户丶ㄋ一丿
框	tvee·木匚一一丨一
眯	bqr·目米丶丿一丨
肆	bsue·镸聿ㄋ一一一
靖	hheei·立青一一丨一
诞	sji·讠丿丨一丨一
赔	dhiu·贝立丨ㄋ一一
浸	ncru·氵彐丶ㄋㄋ丶
蹲	zde·酋一丨丶丶
裳	cjr·衣丶一丿ㄋ
惩	fkrur·彳正丶ㄋ丶丶
钩	vku·钅勹ㄋ丶丶丶
吁	kaee·口于一一丨丨
诀	svo·讠丿丶丶丶
梳	txo·木丿丨ㄋㄋ
聂	yfuru·耳双ㄋ丶ㄋ丶
钥	vhou·钅月丿ㄋ一一
浙	nmei·氵折一丨一丿
搏	gfei·扌甫一丨丶丶
雇	tmo·户隹丿丨丶一
诧	svoe·讠宀丿一ㄋㄋ
灿	pyi·火山丨ㄋ丨丨
浦	nfei·氵甫一丨ㄋ一
窃	dnu·穴七ㄋ丿丿丿
嫣	mkue·女正ㄋ一丶丶
鲍	dkue·鱼勹ㄋ一ㄋㄋ
衷	bvo·亠中丿ㄋ丿丶
丸	gjr·九丶丶丶丶丶
泊	ndoi·氵白丿丨ㄋ一
陡	ymeie·阝走一丨一丨
桶	ttu·木甬ㄋ丶丨ㄋ
躁	zki·口丨ㄋ一丨
蓦	yau·莫马ㄋㄋ一一
胃	ghiue·田⺝丨ㄋ一一
咯	kzo·口各丿ㄋ丶丨
姻	mqi·女因丨ㄋ一丿
砰	dhe·石平一丶丿一
崩	yho·山月丿ㄋ一一
耿	ypr·耳火丶丿丿丶
钧	vkr·钅勹丶一一一
茂	fkeo·艹戊一丿ㄋ丿
恕	mkru·女口丶ㄋ丶丶
佑	jdiu·亻丨ㄋ一一
抄	gvi·扌少丨丿丶丿
隶	cnir·氺丨丶一丿
罕	qfe·冖八一一丨丨
凛	wbi·冫亠丨ㄋ丨ㄋ
驳	aho·马乂丿丶丶丶
茵	fqiu·艹因丨ㄋ一丿
匙	snou·是匕丿ㄋㄋㄋ
萝	wbou·萝夕丿ㄋ丶丶
凰	ade·几白一一丨一
岚	yaorr·山几丿丶丶丶
亨	gcui·了ㄋ丨丨丨
桩	taei·木广一丨一一
掀	maou·折欠丿ㄋ丿丶
侄	jgeu·亻至一ㄋ丶一
斋	nyeo·文而一丿丨ㄋ
贷	bdi·代贝丨ㄋ丿丶
畜	bpi·亠幺丨ㄋ一丨
侦	jliu·亻⺊丨ㄋ丿丶
哨	kciu·口丨ㄋ一一
憾	hkeiu·忄戊一丨ㄋ一
庸	asi·广肀丿ㄋ一一
恳	hlr·艮心丶ㄋ丶丶
栗	tteior·覀木一丨丿丶
啪	kgo·口扌丿丨ㄋ一
尴	xliu·尢丨ㄋ丨丨
绅	xwi·纟日丨丨丨丨
弘	xcur·弓厶ㄋ丶丶丶
携	gmu·扌隹ㄋ丿丿丿
履	zfo·尸彳丿一丨ㄋ
挪	gsuiii·扌ㄋ丨丨丨
狭	pwor·犭𰀆丿丶丶丶
轨	ygou·车九丿ㄋㄋㄋ
茅	fhur·艹矛ㄋ丶ㄋ丨
坟	lnre·土文丶一丿丶
嘶	kgoo·口其丿丿一丨
赠	dwr·贝曾丶丿丨ㄋ
叮	kaei·口丁一丨丨丨
撇	gqoe·扌㡀丿一丿丶
龟	dwuu·日ㄋㄋㄋㄋ
芸	fmee·艹云一一ㄋ丶
後	fpo·彳幺丿丶丿ㄋ
撼	gkei·扌戊一丨ㄋ一
拢	gleo·扌龙一丿ㄋ丿
汝	nmu·氵女ㄋ丿一一
倏	jneor·夂一丿丶丶
霉	pvu·ㄋㄋ丶一
溢	naor·氵䒑丿丶丨ㄋ
靴	qyo·革化丿丨丿ㄋ
壳	bao·几丿ㄋㄋㄋ
尬	xdo·尢人丿丨丨丨
笛	lai·由丨ㄋ一丨
悍	hwee·忄日一一丨丨
乞	vpu·乙ㄋㄋㄋㄋ
肿	hviue·月中丨ㄋ一丨
葡	dfei·芍甫一丨ㄋ一
烫	ntoo·氵㇡丿丿丶丿
宪	vgo·宀先丿一丨一
肢	hpur·月十ㄋ丶丶丶
嘱	kzoi·口尸丿丨ㄋ一
隙	yciu·阝小丨ㄋ一一
啥	kqe·口亼一丨丨ㄋ
翎	qyur·令羽ㄋ丶一ㄋ
忖	hjeir·忄寸一丨丶丶
碑	ddoi·石卑丿丨ㄋ一
裴	zjr·非衣丶一丿ㄋ
浆	zbiu·丬夕丨ㄋ丿丶
艇	psu·舟壬ㄋ丶丶丶
娱	mkee·女口一一丿丶
擒	gdr·扌人丶一丿丶
犬	peo·犬一丿丶丶丶
斌	njeu·文一一ㄋ丶丨
羡	kpr·次丶一丿ㄋ
窄	dzoe·穴乍丿一丨一
拘	gkiuee·扌勹丨ㄋ一一
沐	nteio·氵木一丨丿丶
盲	xbiu·亡目丨ㄋ一一
旭	gwi·九日丨ㄋ一一
郊	qhu·六乂ㄋ丨丨丨
垫	dleie·执土一丨一一
栽	qte·木一丨丿丶
捐	gkiuee·扌口丨ㄋ一一
磊	dde·石石一丿丨ㄋ
哗	kyei·口化一丨丨丨
芦	ftr·艹户丶ㄋ一丿
辜	vnre·古辛丶一丶丿
茜	ftei·艹西一丨ㄋ丿
锡	vwou·钅日丿ㄋ丿丿
秃	cao·禾几丿ㄋㄋㄋ
脂	hni·月匕丨ㄋ一一
棠	cte·木一丨丿丶
酬	twr·酉川丶丶丶丶
侮	jvuu·亻ㄋㄋ丶一
媳	mjru·女自丶ㄋ丶丶
咧	kbii·口歹丨丨丨丨
鸭	afou·甲鸟丿ㄋ丶ㄋ
毯	wpr·毛火丶丿丿丶
坎	laou·土欠丿ㄋ丿丶
涩	nsri·氵刀丶丨一丨
淮	nmo·氵隹丿丨丶一
歹	beo·歹一丿ㄋ丶丶
骆	az·马各丿ㄋ丶丨
饥	paou·饣几丿ㄋㄋㄋ
膛	hcei·月一丨一一
溃	nliu·氵丨ㄋ丿丶
楞	tcr·木罒丶一ㄋ丿
丐	jluu·一⺊ㄋㄋㄋㄋ
券	lsuo·刀ㄋ丿丿丿
逛	psru·犭王丶ㄋ丶丶
煌	pdee·火白一一丨一
潭	ntiu·氵覀丨ㄋ一一
棚	thou·木月丿ㄋ一一
黯	xmr·黑音丶一丶丿
膜	hyei·月莫一丨丨丨
沧	nduuu·氵人ㄋㄋㄋㄋ
堤	lsi·土是丨ㄋ一一
颖	nce·匕禾一丿丨ㄋ
栈	tkee·木戋一一ㄋ丿
耽	yqou·耳冖丿ㄋㄋㄋ
噬	kleieo·口一丨一丿
掷	gaeo·扌䒑一丿丶ㄋ
卒	bfei·亠从一丨丨丨
衍	fnee·彳氵一一丨丨
蔽	fqo·艹㡀丿一丿丶
堕	ydiue·阝丨ㄋ一一
绒	xkeo·纟戈一丿丿丿
栋	tyi·木丨丿丶丶
逍	chr·⺝丶ㄋ丶丶
绸	xsei·纟冂一丨一丨
涅	nwei·氵日一丨一一
呐	kliu·口内丨ㄋ丿丶
绮	xkei·纟大一丨ㄋ一
砖	dyur·石二ㄋ丶丶丶
蹄	zhiu·丨ㄋ丨丨
粘	qti·米占丨一丨ㄋ
魁	swei·鬼⺀一丨丨丨
鸦	afour·牙鸟丿ㄋ丶ㄋ
棺	tvi·木宀丨ㄋ一ㄋ
狡	pqor·犭六丿丶丶丶
妓	mpu·女十ㄋ丶丶丶
昧	wdee·日未丨丿丶丶
萄	dyo·芍缶丿一一丨
呻	kwii·口日丨丨丨丨
盔	dpi·火丨ㄋ丨丨
亩	bgi·亠田丨ㄋ一丨
腻	hkee·月弋一一丨ㄋ
厮	ago·厂其丿丿一丨
兜	dpu·白ㄋ一丿ㄋ
孕	wsu·乃子ㄋ丨一一
敞	csiu·冂丨ㄋ一丿
搅	gniu·扌丨ㄋ丿ㄋ
囚	kdor·囗人丿丶丶丶
脊	ndiu·人丨ㄋ一一
驼	avo·马宀丿ㄋㄋㄋ
巍	ycuo·山禾ㄋ丿一丿
鹅	wfo·我鸟丿ㄋ丶ㄋ
缕	xqu·纟米ㄋ丿一一
滞	nfr·氵丶ㄋ丨ㄋ
矢	voe·矢丿一一丿丶
锤	vzo·钅垂丿一丨一
瞄	bfi·目艹丨ㄋ一丨
痒	lkro·疒羊丶丿一一
塌	lwur·土日ㄋ丶一ㄋ
辟	bue·辟ㄋ一丿丨ㄋ
妾	hmu·立女ㄋ丿一一
汹	nhu·氵乂ㄋ丨丨丨
徽	aduu·糸ㄋㄋ丶丨
嘟	kfui·口者ㄋ丨丨丨
擅	gbi·扌亠丨ㄋ丨ㄋ
阎	fdoi·门丿丨一ㄋ
苹	fher·艹平一丶丿一
株	tjee·木丿丨丿丶丶
榜	threu·木丶一ㄋ丿
盏	kciui·戋皿丨ㄋ丨丨
敛	qmoe·亼丿一丿丶
廖	ayo·广羽丿丶丿丿
咪	kqro·口米丶丿一丨
妞	mau·女丑ㄋ丨一一
掘	gzui·扌尸ㄋ丨丨ㄋ
汁	npei·氵十一丨丨丨
娟	mkiue·女口丨ㄋ一一
澡	nki·氵口丨ㄋ一丨
罐	yfi·缶艹丨ㄋ一丨
勋	kdu·口贝ㄋ丿丿丿
彦	haoo·厂丿丿丿丿
焕	pdiue·火丨ㄋ一丿
呃	kauu·口厂ㄋㄋㄋㄋ
蕴	fxi·艹纟丨ㄋ一一
耕	dye·耒井一一丿丨
俺	jkiue·亻大丨ㄋ一一
荪	fsi·艹孑丨丿丶丶
灼	pkr·火勹丶丶丶丶
冉	sleie·冂土一丨一一
扁	tliu·户丨ㄋ一丨
喧	kveiu·口宀一丨ㄋ一
摧	gyoi·扌山丿丨丶一
蒸	fcu·艹了ㄋ丿丶一
诈	szo·讠乍丿一丨一
杏	tkiu·木口丨ㄋ一一
碌	dci·石丨丶一丿
殖	bhei·歹直一丨丨ㄋ
嵌	ydou·山甘丿ㄋ丿丶
捡	gqr·扌亼丶丶丿一
邱	qyui·丘阝ㄋ丨丨丨
姥	mfou·女耂丿ㄋㄋㄋ
郝	cyui·赤阝ㄋ丨丨丨
璇	sdu·王𭤨ㄋ丨一丿
辕	ynou·车吉丿ㄋ丿丶
厄	agu·厂ㄋㄋㄋㄋ
绽	xpr·纟定丶丶ㄋ一
胀	hboe·月长丿一ㄋ丶
苟	dkiuee·芍口丨ㄋ一一
朽	tweuu·木丂一ㄋㄋㄋ
蜀	ckiue·罒勹丨ㄋ一丨
彬	mwo·林彡丿丿丿丿
喻	kqiu·口亼丨ㄋ一一
肺	hjiui·月一丨ㄋ丨丨
钓	vkrr·钅勹丶丶丶丶
纺	xmre·纟方丶一ㄋ丿
峻	yco·山厶丿丶丿ㄋ
坪	lhe·土平一丶丿一
渠	nvue·氵匚ㄋ一一丨
窥	djiu·穴夫丨ㄋ丿ㄋ
蜡	bpiu·虫龷丨ㄋ一一
咦	kkue·口大ㄋ一ㄋㄋ
霆	psur·壬ㄋ丶丶丶
瑜	sqiu·王亼丨ㄋ一一
缚	xfei·纟甫一丨丶丶
硕	dneo·石页一丿丨ㄋ
枉	tseei·木王一一丨一
睹	bfeie·目者一丨一丿
嫉	mlo·女疒丿一一丿
熙	qgr·巳丶丶丶丶
雯	pnr·文丶一丿丶
肝	hnee·月干一一丨丨
蛛	bjee·虫丿丨丿丶丶
瓷	pje·次瓦一ㄋㄋ丶
粹	qbo·米亠丿丶丿丶
尧	peu·尧一ㄋ丿一一
渺	nbio·氵目丨丿丶丿
暇	wqu·日叚ㄋ一丨一
冈	shor·冂㐅丿丶丶丶
绞	xqo·纟六丿丶丶丶
稽	cxro·禾尢丶丿ㄋ丨
贩	daur·贝ㄋ丶丶丶
溅	ndee·氵贝一一ㄋ丿
喀	kvo·口宀丿ㄋ丶丶
巢	wwe·巛日一丨丿丶
胤	jpiu·丿幺丨ㄋ一一
琉	sx·王丿丨ㄋㄋ
絮	mkuu·女口ㄋㄋ丶丨
蔑	wkr·萝戊丶丶丶丶
瞳	bhiu·目立丨ㄋ一一
斐	znr·非文丶一丿丶
禀	bxe·亠回一一丨丿
俘	jyu·亻爫ㄋ丨一一
凳	yhou·癶豆丿ㄋㄋㄋ
迭	jjru·丿夫丶ㄋ丶丶
焚	mpr·林火丶丿丿丶
泳	njuu·氵丶ㄋㄋ丿丶
衔	fve·彳钅一一丨丨
梨	cne·禾刂一丨丿丶
墅	gheie·里予一丨一一
铸	vxe·钅一丨丶丶
潇	nfue·氵艹ㄋ一一丨
伺	jtei·亻一丨ㄋ一
吱	kpu·口十ㄋ丶丶丶
邵	skui·刀口ㄋ丨丨丨
嘎	kdiu·口丆丨ㄋ一一
祁	hyu·礻阝ㄋ丨丨丨
腥	hwoe·月日丿一一丨
狸	pgiu·犭里丨ㄋ一一
傍	jhre·亻丶一ㄋ丿
滔	nyoi·氵爫丿丨一ㄋ
疫	ldou·疒殳丿ㄋㄋ丶
惭	hyoo·忄车丿丿一丨
畔	gjro·田半丶丿一一
樊	thor·木乂丿丶一丨
帖	yti·巾占丨一丨ㄋ
阮	ylee·阝元一一丿ㄋ
琦	skeiu·王大一丨ㄋ一
唔	kji·口五丨ㄋ一一
莽	fpeo·艹犬一丿丨丨
谣	syoee·讠爫丿一一丨
淘	nko·氵勹丿一一丨
蒲	yfeiu·落甫一丨ㄋ一
吏	lhor·乂丿丶丶丶
沫	ndeei·氵未丨丿丶丶
煮	fnr·者灬丶丶丶丶
敖	kee·敖一一丨一ㄋ
驴	atr·马户丶ㄋ一丿
熬	knrr·敖灬丶丶丶丶
晒	wtei·日西一丨ㄋ丿
捂	gji·扌五丨ㄋ一一
幢	yhiu·巾立丨ㄋ一一
陋	yforu·阝丙丿丶ㄋㄋ
勿	jou·勿丿ㄋ丿丿丿
蹈	zyo·爫丿丨一ㄋ
於	mdr·方人丶丶丶丶
菱	flo·艹土丿丶丿ㄋ
拚	gce·扌厶一丿丨丨
翩	tlu·户ㄋ丶一ㄋ
婢	mdoi·女卑丿丨ㄋ一
虏	dwuo·虍力ㄋ丿丿丿
澄	nyei·氵癶一丨ㄋ一
乍	zoei·乍丿一丨一一
沸	nxoi·氵弓丿丨丨丨
嗡	kcur·口公ㄋ丶一ㄋ
啼	khi·口丨ㄋ丨丨
喔	kze·口尸一ㄋ丶一
襟	hme·礻林一一丨丿
孽	fjiu·艹丿丨ㄋ一ㄋ
叱	kneu·口七一ㄋㄋㄋ
炭	ydr·山丶丿丿丶
趴	zfor·八丿丶丶丶
螺	bgu·虫田ㄋㄋ丶丨
窟	dzu·穴尸ㄋ丨丨ㄋ
垒	ccur·厶厶ㄋ丶一丨
卸	vhui·止ㄋ丨丨丨
捣	gfiu·扌丨ㄋ丨丨
砂	dvio·石少丨丿丶丿
歧	hpurr·止十ㄋ丶丶丶
麒	mgei·鹿其一丨丨一
蚀	pbiue·饣虫丨ㄋ一丨
侣	jkiuee·亻口丨ㄋ一一
绷	xhou·纟月丿ㄋ一一
渗	nco·氵丿丿丿丿
澜	nfeiu·氵门一丨ㄋ一
藉	fdei·艹耒一丨丨一
莺	wfou·鸟丿ㄋ丶ㄋ
淹	nkiu·氵大丨ㄋ一一
薪	fhei·艹立一丨丿丶
毙	mbou·比歹丿ㄋㄋㄋ
僻	jbue·亻辟ㄋ一丿丨
髅	mqu·骨米ㄋ丿一一
叨	ksuo·口刀ㄋ丿丿丿
詹	hfre·厃八丶一一一
迦	trr·加辶丶ㄋ丶丶
荐	fdui·艹ㄋ丨一一
骷	mvei·骨古一丨丨ㄋ
捆	gkeio·扌囗一丨丿丶
嗦	kbuu·口ㄋㄋ丶丨
瞅	bcro·目禾丶丿丿丶
鳞	dqo·鱼米丿ㄋ丶一
擎	dkoeo·芍口丿一丿丶
嗤	kyeiu·口屮一丨ㄋ一
衙	fjiue·彳五丨ㄋ一一
菌	fkoe·艹囗丿一丨丿
聘	yaeu·耳由一ㄋㄋㄋ
膏	gkiuee·口丨ㄋ一一
遁	apiu·十丨ㄋ一一
荫	fyou·艹阝丿ㄋ一一
咙	kleo·口龙一丿ㄋ丿
嚣	hniu·吅页丨ㄋ一丨
朦	hweeo·月一一丿ㄋ
憎	hwro·忄曾丶丿丨ㄋ
吨	kbeu·口屯一ㄋ丨ㄋ
删	ssei·冂冂一丨丨丨
寝	vzu·宀丬ㄋ一一ㄋ
彷	fmre·彳方丶一ㄋ丿
圾	lsou·土及丿ㄋ丶丶
旷	war·日广丶一丿丿
垃	lhre·土立丶一丶丿
稚	cmoir·禾隹丿丨丶一
夭	foe·夭丿一丿丶丶
鞠	qkro·革勹丶丿一丨
磕	dwiu·石去丨ㄋ丨丨
捞	gwuoo·扌ㄋ丿丿丿
梭	tcor·木厶丿丶丿ㄋ
稻	cyo·禾爫丿丨一ㄋ
蚁	bnro·虫义丶丿丶丶
虞	dkeeo·虍口一一丿丶
蹦	zyou·山丿ㄋ一一
秩	cjee·禾丿一一丿丶
哉	qkiu·口丨ㄋ一一
醋	tpiu·酉龷丨ㄋ一一
颂	cneo·公页一丿丨ㄋ
尿	zniu·尸水丨ㄋ丿丶
伞	dwe·人丷一丨丨丨
胧	hleo·月龙一丿ㄋ丿
挫	gfeie·扌从一丨一一
伽	jtuo·亻加ㄋ丿丨ㄋ
兀	jxou·一儿丿ㄋㄋㄋ
梵	mar·林几丶丶丶丶
凸	hieiu·凸丨一丨ㄋ一
弩	cxu·奴弓ㄋ一ㄋㄋ
芷	fhie·艹止丨一丨一
禽	dqi·人㐫丨ㄋㄋ丶
炽	pko·火口丿丶丶丶
屯	beu·屯一ㄋ丨ㄋㄋ
翘	pyur·尧羽ㄋ丶一ㄋ
宵	vciu·宀丨ㄋ一一
诵	stu·讠甬ㄋ丶丨ㄋ
彤	sbo·冂亠丿丿丿丿
雍	bpo·亠丿丿丨丶
虐	dce·虍一ㄋ一一
炒	pvio·火少丨丿丶丿
氧	vkro·气羊丶丿一一
逮	cnr·氺丶ㄋ丶丶
挟	gwor·扌𰀆丿丶丶丶
菩	fhiu·艹立丨ㄋ一一
匕	nou·匕丿ㄋㄋㄋㄋ
猿	pno·犭吉丿ㄋ丿丶
喇	kzii·口束丨丨丨丨
踱	zdu·度ㄋ丶丶丶
噗	kjro·口业丶丿一一
溶	ndor·氵穴丿丶丨ㄋ
舜	ybe·夕一ㄋ丨丨
奢	kfei·大者一丨一丿
袜	hdeei·衤未丨丿丶丶
熄	pjr·火自丶ㄋ丶丶
啤	kdoi·口卑丿丨ㄋ一
橡	twou·木象丿ㄋ丨ㄋ
嘘	kdii·口虍丨丨丶丿
弧	xyo·弓瓜丿丿ㄋ丶
镶	vbiue·钅亠丨ㄋ一丨
嗅	kjeo·口自一丿丶丶
嗔	khorr·口直丿丶丶丶
禄	hcir·礻丨丶一丿
梧	tji·木五丨ㄋ一一
顷	nneo·页一丿丨ㄋ
缆	xliuo·纟丨ㄋ丿ㄋ
蓓	phi·𦫻立丨ㄋ一一
榻	twur·木日ㄋ丶一ㄋ
槐	tsoi·木鬼丿丨ㄋ一
妍	mneeo·女开一一丿丨
谐	smo·讠比丿丨ㄋ一
眶	bvee·目匚一一丨一
挠	gpeu·扌尧一ㄋ丿一
敷	fmo·甫方丿一丿丶
倡	jwiue·亻日丨ㄋ一一
忿	slru·分心丶ㄋ丶丶
揪	gcr·扌禾丶丿丿丶
蝉	bhr·虫单丶丿丨ㄋ
屡	zqu·尸米ㄋ丿一一
饺	pqorr·饣六丿丶丶丶
呕	kme·口区一丿丶ㄋ
龚	lpe·龙共一丨丨一
茹	fmi·艹女丨ㄋ一一
蝎	bwo·虫日丿ㄋ丿丶
缎	xgo·纟段丿丨一一
讥	saou·讠几丿ㄋㄋㄋ
蔓	fwiu·艹日丨ㄋ丨丨
奎	khei·大圭一丨一一
狞	pvei·犭宀一丨丨丨
揽	gliu·扌丨ㄋ丿ㄋ
珑	sleo·王龙一丿ㄋ丿
霎	phuo·立ㄋ丿一一
暑	wfe·日者一丨一丿
婿	mmiu·女疋丨ㄋ一一
哮	kfuie·口耂ㄋ丨一一
嗽	kzou·口束丿ㄋ丿丶
铠	vyu·钅山ㄋ一ㄋㄋ
眩	bbu·目亠ㄋㄋ丶丶
钞	vvio·钅少丨丿丶丿
匀	kwre·勹冫丶一一一
嘀	khiu·口丨ㄋ一丨
襄	bheei·亠吅一一丨丨
蝴	bvou·虫古丿ㄋ一一
珂	sgei·王可一丨ㄋ一
阀	fjeu·门亻一ㄋ丿丶
锻	vgoi·钅段丿丨一一
嚼	kyiu·口爫丨ㄋ丨丨
颓	cae·禾几一丿丨ㄋ
眷	lbiu·目丨ㄋ一一
岔	syi·分山丨ㄋ丨丨
廓	agui·广ㄋ丨一ㄋ
倪	jtouu·亻臼丿ㄋㄋㄋ
卦	hlirr·圭卜丨丶丶丶
譬	bsr·辟言丶一一一
绰	xliue·纟⺊丨ㄋ一一
诅	sbi·讠且丨ㄋ一一
谜	sqr·讠米丶ㄋ丶丶
狈	pdiuo·犭贝丨ㄋ丿丶
咏	kjuu·口丶ㄋㄋ丿丶
陕	ywor·阝𰀆丿丶丶丶
肘	hjeirr·月寸一丨丶丶
梢	tci·木丨ㄋ一一
诛	sjee·讠丿丨丿丶丶
琐	sciuo·王丨ㄋ丿丶
侨	jfoi·亻夭丿丨丨丨
昊	wfee·日天一一丿丶
淳	ngu·氵ㄋ丨一一
桓	tjiu·木一丨ㄋ一一
旬	kwiu·勹日丨ㄋ一一
揍	gleeo·扌一一丿丶
扳	gaur·扌ㄋ丶丶丶
熏	nxi·千黑丨ㄋ丶丿
咸	kleiu·戊一丨ㄋ一
栅	tsi·木冂丨ㄋ一一
纲	xsor·纟冂丿丶丶丶
旱	wnee·日干一一丨丨
嗜	kfou·口耂丿ㄋ丨ㄋ
掐	gdoie·扌丿丨一ㄋ
舔	nfir·舌天丨丶丶丶
瓣	nyr·辛瓜丶一丶丿
棕	tveei·木宀一一丨丿
鸽	cfo·合鸟丿ㄋ丶ㄋ
燥	pki·火口丨ㄋ一丨
噪	kkiuei·口口丨ㄋ一丨
鞍	qvu·革宀ㄋ丿一一
滥	nliui·氵丨ㄋ丨丨
憋	qnr·㡀攵丶ㄋ丶丶
氓	xque·亡民ㄋ一ㄋ一
咆	kkueu·口勹ㄋ一ㄋㄋ
桢	tliuo·木⺊丨ㄋ丿丶
窘	dciu·穴尹丨ㄋ一一
簇	ldoe·𭤨丿一一丿
涡	nkiuo·氵口丨ㄋ丿丶
蕊	flru·艹心丶ㄋ丶丶
霓	pto·臼丿ㄋㄋㄋ
箫	lsoi·肀丿丨丿丶
拧	gve·扌宀一丨丨丨
彪	daoo·虍几丿丿丿丿
凹	hiu·凹丨ㄋ丨ㄋ一
伶	jqo·亻令丿丶丶ㄋ
铅	vaiu·钅几丨ㄋ一一
珀	sdoi·王白丿丨ㄋ一
婶	mviu·女宀丨ㄋ一一
叩	kwui·口卩ㄋ丨丨丨
嚎	kgeo·口一丿ㄋ丿
骏	aco·马厶丿丶丿ㄋ
鞘	qc·革丨ㄋ一一
拙	gyui·扌屮ㄋ丨丨丨
拽	gwuooo·扌日ㄋ丿丿丿
苔	fci·艹厶丨ㄋ一一
跋	zdur·ㄋ丶丶丶
沌	nbe·氵屯一ㄋ丨ㄋ
搓	gkeie·扌一丨一一
瘫	lfoi·疒又丿丨丶一
沛	nji·氵一丨ㄋ丨丨
湛	nguu·氵其ㄋㄋㄋㄋ
琢	shrr·王豕丶丶丶丶
喽	kqu·口米ㄋ丿一一
楠	tpiur·木十丨ㄋ丶丿
抿	gque·扌民ㄋ一ㄋ一
坝	ldiuor·土贝丨ㄋ丿丶
咚	knrrr·口夂丶丶丶丶
壤	lbiue·土亠丨ㄋ一丨
晖	wqeu·日冖一ㄋ一丨
槽	tjiue·木一丨ㄋ一丨
窍	dleu·穴工一ㄋㄋㄋ
娥	mwoe·女我丿一丨一
诃	sgeiu·讠可一丨ㄋ一
撩	gkr·扌大丶丿丨ㄋ
裘	wjr·求衣丶一丿ㄋ
祺	hge·礻其一丨丨一
卵	pjou·丶丿ㄋ丨丶
皓	djoe·白告丿一丨一
沼	nsi·氵刀丨ㄋ一一
芽	faeu·艹牙一ㄋ丨丿
橱	taeiu·木厂一丨ㄋ一
拭	gkeiee·扌弋一丨一一
猾	pmi·犭骨丨ㄋㄋ丶
甸	kgiue·勹田丨ㄋ一丨
沁	nlru·氵心丶ㄋ丶丶
哆	kbou·口夕丿ㄋ丶丶
笙	lgo·生丿一一丨
札	tpuu·木乚ㄋㄋㄋㄋ
缪	xyor·纟羽丿丶丿丿
炯	psiu·火冂丨ㄋ一一
戳	ymeu·羽隹一ㄋ丿丶
粥	xqueu·弓米ㄋ一ㄋㄋ
佟	jnrr·亻夂丶丶丶丶
戮	ydoo·羽人丿丿丿一
剖	hkii·立口丨丨丨丨
奕	pke·亦大一丿丶丶
缸	yleie·缶工一丨一一
悯	hfreo·忄门丶一丿丶
豁	vxiue·宀丰丨ㄋ一丿
栖	tteiu·木西一丨ㄋ丿
禹	jkiui·丿口丨ㄋ丨一
斟	gpr·其乚丶丶一丨
揣	gyeoi·扌山一丿丨ㄋ
懊	hzr·忄丶丿一丨
沮	nbiu·氵且丨ㄋ一一
迸	anr·䒑廾丶ㄋ丶丶
葫	fvo·艹古丿ㄋ一一
扛	gleie·扌工一丨一一
闺	fheie·门圭一丨一一
怅	hboeu·忄长丿一ㄋ丶
缀	xfu·纟双ㄋ丶ㄋ丶
邹	xyuii·刍阝ㄋ丨丨丨
丞	cnee·了一一一一
冀	zge·北田一丨丨一
瞟	bt·目覀一一丨丿
褐	hwouor·衤日丿ㄋ丿丶
戟	xkeu·戈一ㄋ丿丶
峨	ywoe·山我丿一丨一
嬷	myo·女麻丿ㄋ丶丶
犀	znoe·尸氺丿一一丨
寥	vyo·宀羽丿丶丿丿
酿	tju·酉丶ㄋ一一ㄋ
碟	ddue·石廿ㄋ一丨丿
慷	haue·忄广ㄋ一一丨
猩	pwoee·犭日丿一一丨
疚	lto·疒久丿ㄋ丶丶
昼	kqiue·尺旦丨ㄋ一一
淌	nciu·氵丨ㄋ丨ㄋ
棘	qqe·朿朿一丨ㄋ丨
咨	pkiu·次口丨ㄋ一一
酱	zbei·丬夕一丨ㄋ丿
冶	wci·冫厶丨ㄋ一一
绢	xkiu·纟口丨ㄋ一一
阱	yyee·阝井一一丿丨
脯	hfeiu·月甫一丨ㄋ一
滤	ndru·氵虍丶ㄋ丶丶
惫	ngr·夂田丶ㄋ丶丶
浇	npeu·氵尧一ㄋ丿一
疤	lguie·疒巴ㄋ丨一ㄋ
钮	vau·钅丑ㄋ丨一一
萌	fwoue·艹日丿ㄋ一一
茱	fjeei·艹丿丨丿丶丶
臀	zpi·尸共丨ㄋ一一
缴	xdr·纟白丶一ㄋ丿
虔	dnre·虍文丶一丿丶
葱	fjrr·艹勿丶丶ㄋ丶
瑾	syeii·王堇一丨丨一
杉	twoo·木彡丿丿丿丿
霖	pme·林一丨丿丶
懈	hhuo·忄角ㄋ丿丿一
菁	fhee·艹青一一丨一
圳	lwoi·土川丿丨丨丨
觅	yfiu·爫见丨ㄋ丿ㄋ
沦	naoro·氵仑丿丶丿ㄋ
丙	fdorr·丙人丿丶丶丶
蕙	fjiuee·艹一丨ㄋ一一
觑	djiuo·虍业丨ㄋ丿ㄋ
蝇	bkiu·虫口丨ㄋ一一
泻	nque·氵冖ㄋ一一一
蜘	bvi·虫矢丨ㄋ一一
虾	bleir·虫下一丨丶丶
瞻	bho·目厃丿丶丶一
萱	fvei·艹宀一丨ㄋ一
藻	ykiu·落口丨ㄋ一丨
庵	akiu·广大丨ㄋ一一
匣	vaiue·匚甲丨ㄋ一一
叭	kforr·口八丿丶丶丶
煎	anrr·前灬丶丶丶丶
焊	pwee·火日一一丨丨
敝	qno·㡀攵丿一丿丶
佬	jfou·亻耂丿ㄋㄋㄋ
蛟	bqo·虫六丿丶丶丶
挚	dnoe·执手丿一一丨
檐	thorr·木厃丿丶丶一
庐	atru·广户丶ㄋ一丿
谬	syor·讠羽丿丶丿丿
绯	xzi·纟非丨一一一
烘	ppei·火共一丨丨一
搀	gwour·扌丿ㄋ丶丶
辫	nxre·辛纟丶一丶丿
蹙	klio·戊上丨丿丶丨
牡	cleie·牜土一丨一一
唾	kzoe·口垂丿一丨一
舆	tyeo·车一丿丶丶
筷	lhue·忄ㄋ一丿丶
樵	tmrr·木隹丶丶丶丶
蔬	fti·艹乛丨一丨一
唬	kdou·口虍丿ㄋㄋㄋ
逞	ksr·口王丶ㄋ丶丶
炫	pbu·火亠ㄋㄋ丶丶
弊	qne·㡀攵一丿丨丨
忒	klru·弋心丶ㄋ丶丶
酥	tcoe·酉禾丿一丨丿
拣	gyuo·扌ㄋ丿丶丶
钰	vsrr·钅王丶丶丶丶
簿	lnei·氵一丨ㄋ一
漾	nkru·氵丶ㄋㄋ丿
噜	kdiue·口鱼丨ㄋ一一
啧	kxiu·口丨ㄋ丿丶
踉	zju·丶ㄋ一一ㄋ
茄	ftu·艹加ㄋ丿丨ㄋ
浏	nniiii·氵文丨丨丨丨
牟	cco·厶牛丿一一丨
罡	ckei·罒正一丨一丨
剔	wjiiii·日勿丨丨丨丨
跄	zduu·人ㄋㄋㄋㄋ
舵	pvo·舟宀丿ㄋㄋㄋ
吭	kbouu·口亠丿ㄋㄋㄋ
浊	nbiue·氵虫丨ㄋ一丨
澈	nxiu·氵丨ㄋ一一
哧	kce·口赤丿丨丿丶
慑	hyur·忄耳ㄋ丶ㄋ丶
铲	vheo·钅一丿丿丿
膨	haooo·月壴丿丿丿丿
垮	lkee·土大一一ㄋㄋ
兑	kxouu·𠮦儿丿ㄋㄋㄋ
芮	fliu·艹内丨ㄋ丿丶
仕	jlei·亻士一丨一一
霹	pbue·辟ㄋ一丿丨
韧	jsr·韦刀丶丶丶丶
崎	ykei·山大一丨ㄋ一
芯	flrur·艹心丶ㄋ丶丶
拎	gqor·扌令丿丶丶ㄋ
撰	ggue·扌巳ㄋ一ㄋ一
枢	tmeo·木区一丿丶ㄋ
匿	vfeo·匚艹一丿丨ㄋ
蝠	bli·虫丨ㄋ一丨
叟	tjur·臼丨ㄋ丶丶丶
渣	ntiue·氵木丨ㄋ一一
绫	xlo·纟土丿丶丿ㄋ
颅	lze·⺊尸一丿丨ㄋ
颁	sneoi·分页一丿丨ㄋ
祀	hgue·礻巳ㄋ一ㄋㄋ
楣	tzi·木丨ㄋ一一
竿	lneei·干一一丨丨
逾	qhiir·亼⺝丨丨丶ㄋ
腮	hgr·月田丶ㄋ丶丶
厥	aso·厂屰丿ㄋ丿丶
枣	qwrr·朿⺀丶丶丶丶
黝	xpuo·黑幺ㄋ丿丿丿
窒	dgeu·穴至一ㄋ丶一
聋	ly·龙耳一丨丨一
蔚	fze·艹尸一一丨丿
嗨	kno·口氵丿一ㄋㄋ
拇	gvuu·扌母ㄋㄋ丶一
砚	dfi·石见丨ㄋ丿ㄋ
僚	jkro·亻大丶丿丨ㄋ
闸	fai·门甲丨ㄋ一一
芭	fgu·艹巴ㄋ丨一ㄋ
蛊	bci·虫皿丨ㄋ丨丨
锈	vcuo·钅禾ㄋ丿丿丿
惕	hwouoo·忄日丿ㄋ丿丿
讪	syiu·讠山丨ㄋ丨丨
瘤	lpi·疒丨ㄋ一丨
晤	wjiu·日五丨ㄋ一一
蛙	bheie·虫圭一丨一一
驭	afur·马又ㄋ丶丶丶
璧	bsrr·辟王丶丶丶丶
辖	yvee·车宀一一一丨
阙	fsou·门屰丿ㄋ丿丶
媛	mye·女爫一一丿ㄋ
雳	pauoo·厂ㄋ丿丿丿
侃	jko·亻口丿丨ㄋㄋ
邸	mju·氏丶ㄋ丨丨丨
巳	gueu·巳ㄋ一ㄋㄋㄋ
怠	ckru·厶口丶ㄋ丶丶
锣	vcou·钅罒丿ㄋ丶丶
矫	vfo·矢夭丿丨丨丨
驯	awoi·马川丿丨丨丨
讳	sjeeu·讠韦一一ㄋ丨
蔷	fpro·艹十丶丿一丨
灶	ple·火土一丨一一
搔	gfr·扌又丶丨ㄋ一
呸	khee·口不一一一一
兢	vxei·古儿一丨丨ㄋ
鬓	bvoi·髟宀丿丨一丨
肋	hwuo·月力ㄋ丿丿丿
诏	ssi·讠刀丨ㄋ一一
镯	vcoui·钅罒丿ㄋ丨ㄋ
娴	mfei·女门一丨丿丶
髓	mdeie·骨一丨一丶
橘	thiu·木矛丨ㄋ丿丶
棱	tlor·木土丿丶丿ㄋ
擂	gpiue·扌丨ㄋ一丨
姗	msiu·女冂丨ㄋ一一
帜	ykor·巾口丿丶丶丶
蹬	zyei·癶一丨ㄋ一
跺	zaei·几一丨丿丶
琛	sqor·王冖丿丶一丨
筝	lbouu·争丿ㄋㄋ一
懦	hpeo·忄一丿丨ㄋ
翡	zyur·非羽ㄋ丶一ㄋ
婪	mmu·林女ㄋ丿一一
瘾	lyo·疒阝丿ㄋㄋ一
赎	dpur·贝十ㄋ丶丶一
巩	larr·工几丶丶丶丶
钗	vfr·钅又丶丶丶丶
蚕	fbi·天虫丨ㄋ一丨
晏	wvu·日宀ㄋ丿一一
刁	tjeee·一一一一一
庇	ameu·广比一ㄋ丿ㄋ
篱	lqiu·㐫丨ㄋㄋ丶
漓	nqi·氵㐫丨ㄋㄋ丶
庚	acor·广彐丿丶丶丶
轧	ypuu·车乚ㄋㄋㄋㄋ
蚂	bau·虫马ㄋㄋ一一
邢	nyui·开阝ㄋ丨丨丨
锥	vmoi·钅隹丿丨丶一
熔	pdor·火穴丿丶丨ㄋ
叁	cpe·三一一一一
嬉	mai·女壴丨ㄋ一一
茗	fbiu·艹夕丨ㄋ一一
驿	afee·马又一一丨丨
帧	yliu·巾⺊丨ㄋ丿丶
瀑	nweii·氵日一丨丨一
窑	dyoe·穴缶丿一一丨
偎	jgeuo·亻田一ㄋ丿丶
檀	tbi·木亠丨ㄋ丨ㄋ
寰	vce·宀罒一丨ㄋ一
骸	mhre·骨亥丶一ㄋ丿
铝	vkiue·钅口丨ㄋ一一
饲	pte·饣一丨ㄋ一
铮	vbo·钅争丿ㄋㄋ一
辐	yliue·车丨ㄋ一丨
蔼	fsiu·艹讠丨ㄋ一一
秉	ccue·禾彐ㄋ一一一
钝	vbe·钅屯一ㄋ丨ㄋ
徊	fxiu·彳回丨ㄋ丨ㄋ
阐	fhro·门单丶丿丨ㄋ
惘	hsr·忄冂丶丿一丶
酋	dro·酋丶丿一丨ㄋ
捶	gzoe·扌垂丿一丨一
瑛	sfi·王艹丨ㄋ一丿
凿	jku·业ㄋ丨丨丨
甄	tleu·覀土一ㄋㄋ丶
弛	xduiu·弓也ㄋ丨ㄋㄋ
噩	skiue·王口丨ㄋ一丨
洽	ncor·氵合丿丶一丨
渝	nqiu·氵亼丨ㄋ一一
蟹	hsoe·角刀丿一一丨
窦	dpurr·穴十ㄋ丶丶一
捅	gtu·扌甬ㄋ丶丨ㄋ
倭	jcuo·亻禾ㄋ丿一一
拴	gdeei·扌人一一丨一
扒	gfor·扌八丿丶丶丶
砌	dnuo·石七ㄋ丿丿丿
咋	kzoei·口乍丿一丨一
玑	saouu·王几丿ㄋㄋㄋ
悼	hliu·忄⺊丨ㄋ一一
穹	dx·穴弓ㄋ一ㄋㄋ
萎	fcuo·艹禾ㄋ丿一一
涕	nxro·氵弟丶丿ㄋ一
绊	xjro·纟半丶丿一一
蚊	bnreo·虫文丶一丿丶
踹	zyeo·山一丿丨ㄋ
峭	yciue·山丨ㄋ一一
笃	lauu·马ㄋㄋ一一
稣	dco·鱼禾丿一丨丿
秽	cyou·禾山丿ㄋ丶丶
贬	djrur·贝丿丶ㄋ丶丶
徘	fzi·彳非丨一一一
遏	wkoru·日勹丿丶ㄋ丶
睫	bju·目一ㄋ一一丨
癌	lkiu·疒口丨ㄋ一丨
禾	coei·禾丿一丨丿丶
揖	gkeii·扌口一丨丨一
潢	npiu·氵丨ㄋ一丨
纬	xjee·纟韦一一ㄋ丨
碳	dyeo·石山一丿丶丿
溺	nxrer·氵弓丶一丶一
哝	klruo·口农丶ㄋ丿ㄋ
榆	tqiu·木亼丨ㄋ一一
彰	mpo·音十丿丿丿丿
蹭	zwr·曾丶丿丨ㄋ
歆	maouo·音欠丿ㄋ丿丶
悴	hbor·忄亠丿丶丿丶
厕	adii·厂贝丨丨丨丨
璐	szou·王丿ㄋ丶丨
拯	gcuo·扌了ㄋ丿丶一
癫	lhore·疒直丿丶一丿
酌	tkrr·酉勹丶丶丶丶
惚	hjru·忄勿丶ㄋ丶丶
睬	byei·目爫一丨丿丶
瀚	nxor·氵丿丶ㄋ丶
驹	akiue·马勹丨ㄋ一一
狰	pbou·犭争丿ㄋㄋ一
庶	dnrr·度灬丶丶丶丶
竺	lye·二一一一一
眺	bxr·目儿丶一丿丶
墟	ldii·土虍丨丨丶丿
屉	zduuu·尸廿ㄋㄋㄋㄋ
褪	hhru·衤艮丶ㄋ丶丶
穗	cji·禾一丨ㄋ一一
赦	cnoeor·赤攵丿一丿丶
瑚	svou·王古丿ㄋ一一
歼	bnoe·歹千丿一丨丨
颐	qneo·页一丿丨ㄋ
啃	khiue·口止丨ㄋ一一
醇	tgui·酉ㄋ丨一一
憔	hmr·忄隹丶丶丶丶
滕	hlire·月丨丶一丿
忏	hno·忄千丿一丨丨
雏	xmoi·刍隹丿丨丶一
泵	dniu·石水丨ㄋ丿丶
呛	kduu·口人ㄋㄋㄋㄋ
谴	sliu·讠丨ㄋ一ㄋ
颔	qkeo·今口一丿丨ㄋ
唧	ktui·口ㄋ丨丨丨
皂	dneu·白七一ㄋㄋㄋ
缄	xkeiu·纟戊一丨ㄋ一
柬	zwrr·束丷丶丶丶丶
曙	wce·日罒一丨一丿
喳	ktiu·口木丨ㄋ一一
椒	tlio·木上丨丿丶ㄋ
叽	kaou·口几丿ㄋㄋㄋ
踌	zxe·一丨丶丶
祟	yseei·屮凵一一丨丿
祠	hteiu·礻一丨ㄋ一
肮	hbou·月亠丿ㄋㄋㄋ
鹃	khou·口⺝丿ㄋ丶ㄋ
朔	shou·屰月丿ㄋ一一
晦	wvuu·日ㄋㄋ丶一
悸	hcu·忄禾ㄋ丨一一
靡	yzi·麻非丨一一一
炳	pfo·火丙丿丶丶丶
鸾	pfou·亦鸟丿ㄋ丶ㄋ
袱	hjeo·衤亻一丿丶丶
怦	hher·忄平一丶丿一
娄	qmu·米女ㄋ丿一一
氨	vvuo·气宀ㄋ丿一一
硫	dxo·石丿丨ㄋㄋ
睿	lqe·⺊冖一丿丶丿
曳	wpo·日乚丿丿丿丿
嗳	kyeo·口一丿ㄋ丶
衅	jcro·丿皿丶丿一一
唠	kwuo·口ㄋ丿丿丿
倔	jzu·亻尸ㄋ丨丨ㄋ
褂	hhirr·衤圭丨丶丶丶
匈	khu·勹乂ㄋ丨丨丨
勘	gpuo·其乚ㄋ丿丿丿
傀	jsoi·亻鬼丿丨ㄋ一
锯	vzei·钅尸一丨丨ㄋ
躇	zfei·艹一丨一丿
剿	wwei·巛日一丨丿丶
蟒	bfeo·虫艹一丿丶丶
缉	xkeii·纟口一丨丨一
玮	sjeeui·王韦一一ㄋ丨
妲	mqiu·女旦丨ㄋ一一
俭	jqr·亻亼丶丶丿一
粪	qpe·米共一丨丨一
髦	bwoe·髟毛丿一一ㄋ
馈	pli·饣丨ㄋ丿丶
贮	dve·贝宀一一一一
镑	vhr·钅丶一ㄋ丿
岑	yqorr·山今丿丶丶ㄋ
惮	hhroi·忄单丶丿丨ㄋ
簧	lpiu·丨ㄋ一丨
缰	xjiu·纟一丨ㄋ一丨
侥	jpeu·亻尧一ㄋ丿一
涤	nneio·氵夂一丨丿丶
贿	ddiu·贝丨ㄋ一一
谍	sdue·讠廿ㄋ一丨丿
浣	nvee·氵宀一一丿ㄋ
淇	ngeii·氵其一丨丨一
攒	ggoe·扌先丿一丨一
藩	ymi·落釆丨ㄋ一丨
赁	jsiu·亻壬丨ㄋ丿丶
雌	tmoi·此隹丿丨丶一
沪	ntr·氵户丶ㄋ一丿
拌	gjroe·扌半丶丿一一
巅	yhor·山直丿丶一丿
榴	tpiue·木丨ㄋ一丨
梗	tbe·木更一丨ㄋ一
袅	fjre·衣丶一丿ㄋ
芊	fnoei·艹千丿一丨丨
腺	hdiuo·月白丨ㄋ丿丶
狙	pbiuee·犭且丨ㄋ一一
讼	sco·讠公丿丶ㄋ丶
漩	nduie·氵𭤨ㄋ丨一丿
抒	ghur·扌予ㄋ丶ㄋ丨
啜	kfuru·口双ㄋ丶ㄋ丶
笠	lhrer·立丶一丶丿
嘈	kjiu·口一丨ㄋ一丨
杠	tlei·木工一丨一一
蕉	fmrr·艹隹丶丶丶丶
剃	xnii·弟刂丨丨丨丨
褚	hfeie·衤者一丨一丿
茉	fdee·艹未丨丿丶丶
俐	jcii·亻禾丨丨丨丨
奠	dkeo·酋大一丿丶丶
茎	fpure·艹轻ㄋ丶一丨
绛	xneu·纟夂一ㄋ丨丨
熠	pyoi·火羽丿丨ㄋ一
苇	fjeeu·艹韦一一ㄋ丨
峙	yleir·山土一丨丶丶
阑	fzr·门束丶丶丶丶
磷	dqou·石米丿ㄋ丶一
肾	mhi·⺝丨ㄋ一一
儡	jgiue·亻田丨ㄋ一丨
冗	qao·冖几丿ㄋㄋㄋ
恬	hnoe·忄舌丿一丨丨
妩	mje·女一一丿ㄋㄋ
毋	vuu·毋ㄋㄋ丿一一
哽	kbei·口更一丨ㄋ一
厘	agi·厂里丨ㄋ一一
蝙	bti·虫户丨ㄋ一丨
膳	hkro·月羊丶丿一丨
濑	nzoui·氵束丿ㄋ丨ㄋ
墩	lguieo·土ㄋ丨一丿
稼	cve·禾宀一丿ㄋ丿
曦	wkoe·日丿一丨丿
恃	hleir·忄土一丨丶丶
婕	mjue·女一ㄋ一一丨
苛	fge·艹可一丨ㄋ一
汀	naei·氵丁一丨丨丨
窖	djoei·穴告丿一丨一
辙	yxi·车丨ㄋ一一
烙	pzou·火各丿ㄋ丶丨
诫	skeoi·讠戈一丿丨丨
筠	llou·土丿ㄋ丶一
惆	hse·忄冂一丨一丨
炕	pbouu·火亠丿ㄋㄋㄋ
溯	nsou·氵屰丿ㄋ一一
镰	var·钅广丶丿一ㄋ
咄	kyui·口屮ㄋ丨丨丨
琵	sseu·王王一ㄋ丿ㄋ
磅	dhr·石丶一ㄋ丿
炙	bpro·火丶丿丿丶
洼	nhe·氵圭一丨一一
邑	kguie·口巴ㄋ丨一ㄋ
玖	sto·王久丿ㄋ丶丶
涟	nyru·氵车丶ㄋ丶丶
疮	ldu·疒人ㄋㄋㄋㄋ
帷	ymoi·巾隹丿丨丶一
萦	wdu·糸ㄋㄋ丶丨
毡	wti·毛占丨一丨ㄋ
摹	ynoe·莫手丿一一丨
炬	pvue·火匚ㄋ一一一
猝	pbor·犭亠丿丶丿丶
桨	zbeio·丬夕一丨丿丶
坂	laur·土ㄋ丶丶丶
募	ywuo·莫力ㄋ丿丿丿
筛	lneiu·一丨ㄋ丨
飙	ppeo·犬犬一丿丶丶
缅	xhe·纟面一丿丨ㄋ
涧	nfiue·氵门丨ㄋ一一
恺	hyue·忄山ㄋ一ㄋㄋ
戎	kdeo·戈一丿丿丿
鹫	lxr·京尢丶丿ㄋ丶
睦	blo·目土丿丶一丨
茸	fyeiie·艹耳一丨丨一
枭	fteio·木一丨丿丶
鸳	bgo·夕丿ㄋ丶ㄋ
殆	bciu·歹厶丨ㄋ一一
奚	ypeo·爫幺一丿丶丶
笺	lkeeu·戋一一ㄋ丿
酣	tde·酉甘一丨丨一
诬	slo·讠工丿丶丿丶
嵩	ygi·山丨ㄋ一一
奄	kwuu·大日ㄋㄋㄋㄋ
韶	msiue·音刀丨ㄋ一一
闽	fbiue·门虫丨ㄋ一丨
悚	hze·忄束一丨ㄋ一
瑕	squ·王叚ㄋ一丨一
谕	sqiue·讠亼丨ㄋ一一
俨	jsoo·亻亚丿丿丿丿
袄	hfoe·衤夭丿一丿丶
亢	baou·亠几丿ㄋㄋㄋ
惋	hvou·忄宀丿ㄋ丶ㄋ
氯	vcir·气丨丶一丿
匡	vsee·匚王一一丨一
糙	qjru·米告丶ㄋ丶丶
屿	yqe·山与一一一一
靓	hfiu·青见丨ㄋ丿ㄋ
嗖	ktiur·口臼丨ㄋ丶丶
淀	nprr·氵定丶丶ㄋ一
憨	tyoe·乛耳丿一丿丶
聆	yqorru·耳令丿丶丶ㄋ
坞	lku·土勹ㄋ一一一
粤	zqe·米一ㄋㄋㄋ
璋	smei·王音一丨丨丨
槛	tliui·木丨ㄋ丨丨
鬟	bce·髟罒一丨ㄋ一
屎	zqr·尸米丶丿一丨
迄	vpru·乙丶ㄋ丶丶
畴	gxe·田一丨丶丶
蚩	yji·屮一丨ㄋ一丨
漪	npeo·氵犭一丿丶一
趾	zhie·止丨一丨一
骡	aguu·马田ㄋㄋ丶丨
桔	tnei·木吉一丨一丨
芜	fjeo·艹一一丿ㄋㄋ
葵	fyeeo·艹癶一一丿丶
忡	hviuei·忄中丨ㄋ一丨
孜	snoeo·孑攵丿一丿丶
隧	ywe·阝丷一丿ㄋ丿
陨	ykiuo·阝口丨ㄋ丿丶
崭	yyo·山车丿丿一丨
勺	kjrr·勹丶丶丶丶丶
羁	cqu·罒革ㄋㄋ一一
撮	gweii·扌日一丨丨一
抡	gaor·扌仑丿丶丿ㄋ
烹	gcrr·了丶丶丶丶
揩	gmo·扌比丿丨ㄋ一
圭	heie·圭一丨一一丨
筵	lji·丿丨一丨一
嗒	kfore·口艹丿丶一丨
掣	vyi·巾丨丨丿一
咎	nliue·夂卜丨ㄋ一一
搐	gbuur·扌亠ㄋㄋ丶丨
侈	jbou·亻夕丿ㄋ丶丶
亵	bdo·亠执丿ㄋ丿丶
腑	haor·月广丿丶一丨
隋	ydeie·阝一丨一丨
橙	tyei·木癶一丨ㄋ一
咀	kbiue·口且丨ㄋ一一
捻	gqru·扌今丶ㄋ丶丶
瘟	lwiui·疒日丨ㄋ丨丨
暧	wyeo·日一丿ㄋ丶
簌	lzou·束丿ㄋ丿丶
苯	ftee·艹木一一一一
啰	kcou·口罒丿ㄋ丶丶
吝	nkiue·文口丨ㄋ一一
闵	fnre·门文丶一丿丶
惺	hwoee·忄日丿一一丨
卉	pneo·十廾一丿丨丨
鲸	dlre·鱼京丶一丨ㄋ
掺	gcoo·扌丿丿丿丿
睨	bto·目臼丿ㄋㄋㄋ
髯	bse·髟冂一丨一一
漱	nzouo·氵束丿ㄋ丿丶
嗣	klue·口ㄋ一丨ㄋ
碱	dkei·石戊一丨ㄋ一
拷	gfeu·扌耂一ㄋㄋㄋ
恙	klrur·心丶ㄋ丶丶
靳	qqo·革斤丿丿一丨
澎	naoo·氵壴丿丿丿丿
吠	kpeo·口犬一丿丶丶
钳	vde·钅甘一丨丨一
吆	kpuu·口幺ㄋㄋ丶丶
呱	kyo·口瓜丿丿ㄋ丶
肴	hdiue·乂丨ㄋ一一
缔	xhiu·纟丨ㄋ丨丨
蛾	bwoei·虫我丿一丨一
攘	gbiu·扌亠丨ㄋ一丨
疙	lvu·疒ㄋㄋㄋㄋ
矜	hqorru·矛今丿丶丶ㄋ
拗	gpuoo·扌幺ㄋ丿丿丿
佯	jkroe·亻羊丶丿一一
萤	wbiu·虫丨ㄋ一丨
汰	nkrr·氵大丶丶丶丶
笋	lcue·尹ㄋ一一丿
馒	pwiu·饣日丨ㄋ丨丨
迢	skru·刀口丶ㄋ丶丶
冢	qhrr·冖豕丶丶丶丶
琶	ssu·王王ㄋ丨一ㄋ
廿	deiie·廿一丨丨一一
沥	nauo·氵厂ㄋ丿丿丿
扼	gauu·扌厂ㄋㄋㄋㄋ
宦	vqe·宀臣一丨ㄋ一
鸥	mfour·区鸟丿ㄋ丶ㄋ
寅	vjiu·宀一丨ㄋ一丨
赘	kdiuo·敖贝丨ㄋ丿丶
蜷	blu·虫ㄋㄋㄋㄋ
蒜	fsee·艹示一一丨丿
痰	lpr·疒火丶丿丿丶
髻	bnei·髟吉一丨一丨
蹑	zyuru·耳ㄋ丶ㄋ丶
璞	sjro·王业丶丿一一
垢	lae·土一丨ㄋ一
捺	gkee·扌大一一丨丿
圃	kfeiu·囗甫一丨ㄋ一
掳	gduo·扌虍ㄋ丿丿丿
镀	vdu·钅度ㄋ丶丶丶
礁	dmr·石隹丶丶丶丶
卤	thorrr·占乂丿丶丶丶
箍	lge·扌一丨ㄋ丨
槟	tvo·木宀丿丨一丨
羹	knro·灬丶丿一一
讷	sliuo·讠内丨ㄋ丿丶
裔	jsori·衣冂丿丶丨ㄋ
鸠	gfour·九鸟丿ㄋ丶ㄋ
芹	fqoo·艹斤丿丿一丨
桦	tyeii·木化一丨丨丨
畸	gkeiu·田大一丨ㄋ一
遐	qrru·叚辶丶ㄋ丶丶
薰	fniu·艹千丨ㄋ丶丿
霏	pzi·非丨一一一
琅	sju·王丶ㄋ一一ㄋ
冕	wwou·日丿ㄋㄋㄋ
钵	vtee·钅木一一一一
馅	pdoi·饣丿丨一ㄋ
磋	dkeie·石一丨一一
涣	ndiue·氵丨ㄋ一丿
缭	xkro·纟大丶丿丨ㄋ
渎	npur·氵十ㄋ丶丶一
贰	kyiuo·弋二丨ㄋ丿丶
渥	nzeu·氵尸一ㄋ丶一
翟	ymoir·羽隹丿丨丶一
拈	gtie·扌占丨一丨ㄋ
鸯	skou·冂大丿ㄋ丶ㄋ
褥	hyeir·衤辰一丨丶丶
祯	hliuo·礻⺊丨ㄋ丿丶
栓	tdee·木人一一丨一
荔	fwuou·艹力ㄋ丿ㄋ丿
筐	lvee·匚一一丨一
瘪	ljo·疒自丿丶丿ㄋ
焱	pproor·火火丶丿丿丶
乒	qjo·丘丿丿丿丿丿
涎	njie·氵丿丨一丨一
沅	nlee·氵元一一丿ㄋ
埔	lfeiu·土甫一丨ㄋ一
噎	kbeiu·口一丨ㄋ一
烯	pheo·火乂一丿丨ㄋ
榕	tdor·木穴丿丶丨ㄋ
粟	tqro·覀米丶丿一丨
菇	fmei·艹女一丨丨ㄋ
昵	wzo·日尸丿ㄋㄋㄋ
恤	hjiuii·忄丿丨ㄋ丨丨
啄	khrr·口豕丶丶丶丶
韬	jyoi·韦爫丿丨一ㄋ
阜	jheii·丿㠯一丨丨丨
孚	ysui·爫子ㄋ丨一一
桅	thu·木厃ㄋㄋㄋㄋ
炀	ptoo·火㇡丿丿丿丿
荧	wpro·火丶丿丿丶
殴	mdou·区殳丿ㄋㄋ丶
暄	wve·日宀一丨ㄋ一
埠	ljiu·土丿丨ㄋ一ㄋ
鹊	pwou·龷日丿ㄋ丶ㄋ
诣	sni·讠匕丨ㄋ一一
惦	haie·忄广丨一丨ㄋ
蠕	bpe·虫一丿丨ㄋ
椎	tmoir·木隹丿丨丶一
绥	xyuo·纟爫ㄋ丿一一
跷	zpeu·尧一ㄋ丿一
衲	hliuor·衤内丨ㄋ丿丶
黏	cdir·禾人丨丶一丿
傩	jfoir·亻又丿丨丶一
癖	lbue·疒辟ㄋ一丿丨
靶	qgu·革巴ㄋ丨一ㄋ
矗	hhei·直直一丨丨ㄋ
陇	yleo·阝龙一丿ㄋ丿
锭	vprr·钅定丶丶ㄋ一
胥	mhiu·疋⺝丨ㄋ一一
渍	nxiuo·氵丨ㄋ丿丶
崽	ygr·山田丶ㄋ丶丶
嚓	kvou·口宀丿ㄋ丶丶
汲	nsour·氵及丿ㄋ丶丶
叼	kteee·口一一一一
锄	vbuo·钅且ㄋ丿丿丿
囔	kbiuei·口丨ㄋ一丨
羔	knrrrr·灬丶丶丶丶
莞	fvee·艹宀一一丿ㄋ
吮	kcouu·口厶丿ㄋㄋㄋ
绎	xfee·纟又一一丨丨
亥	hreu·亥丶一ㄋ丿丿
狩	pveir·犭宀一丨丶丶
煽	ptur·火户ㄋ丶一ㄋ
炊	paouo·火欠丿ㄋ丿丶
锚	vfiu·钅艹丨ㄋ一丨
蹋	zwu·日ㄋ丶一ㄋ
壑	lqeo·⺊冖一丿丶丿
剌	znii·束刂丨丨丨丨
薯	wfei·萝者一丨一丿
昕	wqo·日斤丿丿一丨
岱	byi·代山丨ㄋ丨丨
阈	fkiu·门戈丨ㄋ一一
挛	pnoe·亦手丿一一丨
鲤	dgiu·鱼里丨ㄋ一一
萃	fbor·艹亠丿丶丿丶
鹦	dduoe·贝贝ㄋ丿一丿
茧	fbiuei·艹虫丨ㄋ一丨
懿	bhre·豆丶一丿ㄋ
恻	hdii·忄贝丨丨丨丨
岐	ypur·山十ㄋ丶丶丶
谛	shiu·讠丨ㄋ丨丨
浚	ncoro·氵厶丿丶丿ㄋ
凋	wsei·冫冂一丨一丨
甥	gguo·生田ㄋ丿丿丿
楷	tmoiu·木比丿丨ㄋ一
绚	xkiue·纟勹丨ㄋ一一
瞩	bzo·目尸丿丨ㄋ一
窿	dyou·穴阝丿ㄋ丶一
秤	cher·禾平一丶丿一
殃	bseo·歹冂一丿丶丶
癸	yfee·癶天一一丿丶
隅	ywiui·阝日丨ㄋ丨一
铎	vfee·钅又一一丨丨
钊	vni·钅刂丨丨丨丨
恂	hkiue·忄勹丨ㄋ一一
啐	kbor·口亠丿丶丿丶
铨	vdee·钅人一一丨一
鄂	hyuu·吅二ㄋㄋ丨丨
佘	dsee·人示一一丨丿
舶	pdoiu·舟白丿丨ㄋ一
胺	hvuo·月宀ㄋ丿一一
瘩	lfore·疒艹丿丶一丨
娼	mwiu·女日丨ㄋ一一
晁	wxre·日儿丶一丿丶
锵	vzou·钅丬丿ㄋ丶一
貂	dsi·豸刀丨ㄋ一一
肇	tnu·户攵ㄋ一一一
喏	kfeo·口艹一丿丨ㄋ
殉	bkiue·歹勹丨ㄋ一一
酶	tvuu·酉ㄋㄋ丶一
飕	ahoi·几乂丿丨一ㄋ
泌	nloo·氵心丿丿丿丿
憧	hhiu·忄立丨ㄋ一一
赃	dae·贝广一丨一一
炖	pbeu·火屯一ㄋ丨ㄋ
垄	llei·龙土一丨一一
柿	tbiu·木亠丨ㄋ丨丨
玺	asr·尔王丶丶丶丶
胭	hqiue·月因丨ㄋ一丿
扉	tzie·户非丨一一一
筱	ljoe·丿一丿丶
甭	htou·不用丿ㄋ一一
铐	vfeu·钅耂一ㄋㄋㄋ
谑	sdeu·讠虍一ㄋ一一
鹭	zzo·各丿ㄋ丶ㄋ
佰	jjo·亻一丿丨ㄋ一
籁	lzoui·束丿ㄋ丨ㄋ
芠	fnreo·艹文丶一丿丶
瓢	tsoo·覀示丿丿ㄋ丶
汕	nyiu·氵山丨ㄋ丨丨
梓	tnre·木辛丶一丶丿
伫	jvee·亻宀一一一一
鲨	nvou·氵少丿ㄋ丨ㄋ
瞿	bboi·目目丿丨丶一
眈	bqou·目冖丿ㄋㄋㄋ
孰	gsou·孑丿ㄋ丶丶
驮	akeor·马大一丿丶丶
漉	nmr·氵鹿丶一丿ㄋ
幡	ymiu·巾釆丨ㄋ一丨
壕	lgeo·土一丿ㄋ丿
稷	cgo·禾田丿丶丿ㄋ
蹿	zdi·穴丨ㄋ一丨
攥	gliue·扌丨ㄋ一一
烽	pnee·火夂一一一丨
飒	haorr·立几丿丶丶丶
紊	nduur·文糸ㄋㄋ丶丨
渭	ngiu·氵田丨ㄋ一一
幺	puu·幺ㄋㄋ丶丶丶
撅	garo·扌厂丶丿一ㄋ
侬	jlruo·亻农丶ㄋ丿ㄋ
枷	ttuo·木加ㄋ丿丨ㄋ
寐	vkee·宀爿丨丿丶丶
濮	njii·氵亻丨丨丶丿
霭	psiue·讠丨ㄋ一一
痊	ldee·疒人一一丨一
唰	kziu·口尸丨ㄋ丨丨
麾	ywoee·麻毛丿一一ㄋ
嗟	kkeie·口一丨一一
喋	kdue·口廿ㄋ一丨丿
臻	glo·至丿一丨丿
殡	bvoie·歹宀丿丨一丨
栩	tyur·木羽ㄋ丶一ㄋ
幌	ywir·巾日丨丶丿一
乓	qjrrr·丘丶丶丶丶丶
炜	pjee·火韦一一ㄋ丨
馀	pqe·饣亼一丨丿丶
醺	tni·酉千丨ㄋ丶丿
皙	tqoi·木斤丿丨ㄋ一
珏	ssrr·王王丶丶丶丶
烬	pkrr·火尺丶丶丶丶
矶	daouu·石几丿ㄋㄋㄋ
痉	lpu·疒轻ㄋ丶一丨
辗	yze·车尸一丨丨一
缨	xdiuo·纟贝丨ㄋ丿丶
氢	vpur·气轻ㄋ丶一丨
桀	bjei·夕㐄一丨丿丶
嵋	yziu·山丨ㄋ一一
迂	arru·于辶丶ㄋ丶丶
舷	pbuu·舟亠ㄋㄋ丶丶
堰	lviu·土匚丨ㄋ一一
簪	lneu·旡一ㄋ丿ㄋ
虬	bpuu·虫乚ㄋㄋㄋㄋ
砾	dpio·石丨丿丶丶
谤	shre·讠丶一ㄋ丿
垣	ljiue·土一丨ㄋ一一
袒	hqiuee·衤旦丨ㄋ一一
邃	dweo·穴丷一丿ㄋ丿
硅	dhei·石圭一丨一一
垦	hleiee·艮土一丨一一
锺	vniu·钅千丨ㄋ一一
黔	xqor·黑今丿丶丶ㄋ
煜	pwre·火日丶一丶丿
哺	kfeiue·口甫一丨ㄋ一
戾	tpe·户犬一丿丶丶
忐	llru·上心丶ㄋ丶丶
谒	swou·讠日丿ㄋ丿丶
簸	lguo·其ㄋ丿丨ㄋ
峦	pyiu·亦山丨ㄋ丨丨
犁	cnoee·禾刂丿一一丨
攫	gbiue·扌目丨ㄋ一一
戬	sweu·亚日一ㄋ丿丶
辄	yyuu·车耳ㄋㄋㄋㄋ
碾	dze·石尸一丨丨一
撵	gjeeo·扌夫一一丿丶
饵	pyei·饣耳一丨丨一
谏	szr·讠束丶丶丶丶
曝	wweii·日日一丨丨一
厩	ateu·厂一ㄋ丿ㄋ
鹉	jkiei·一弋丨一丨一
馋	pwour·饣丿ㄋ丶丶
偌	jfeo·亻艹一丿丨ㄋ
忑	llrur·下心丶ㄋ丶丶
酪	tzo·酉各丿ㄋ丶丨
潺	nzui·氵尸ㄋ丨一一
惴	hyeo·忄山一丿丨ㄋ
芥	fdoii·艹人丿丨丨丨
癞	lzouiu·疒束丿ㄋ丨ㄋ
毓	vvr·母丶一ㄋ丶
泓	nxur·氵弓ㄋ丶丶丶
咔	klir·口上丨丶丶丶
蛤	bcor·虫合丿丶一丨
皎	dqor·白六丿丶丶丶
邬	kteu·勹㇉一ㄋ丨丨
噤	kmee·口林一一丨丿
匾	vtiu·匚户丨ㄋ一丨
蟾	bhor·虫厃丿丶丶一
盎	skiui·冂大丨ㄋ丨丨
痹	lgiu·疒畀丨ㄋ一丨
沂	nqoo·氵斤丿丿一丨
阖	fwiui·门去丨ㄋ丨丨
悻	hlro·忄土丶丿一一
褶	hyoi·衤羽丿丨ㄋ一
盂	aci·于皿丨ㄋ丨丨
琥	sdou·王虍丿ㄋㄋㄋ
嗷	kkee·口敖一一丨一
沽	nveii·氵古一丨丨ㄋ
榨	tdoe·木穴丿一丨一
偕	jmo·亻比丿丨ㄋ一
隘	yaori·阝䒑丿丶丨ㄋ
棣	tcir·木丨丶一丿
蜒	bjie·虫丿丨一丨一
椭	tyeoi·木阝一丿丨ㄋ
硝	dciue·石丨ㄋ一一
缤	xvoi·纟宀丿丨一丨
缥	xte·纟覀一一丨丿
甬	tur·甬ㄋ丶丨ㄋ一
唆	kcor·口厶丿丶丿ㄋ
麓	mmre·林鹿丶一丿ㄋ
昱	whre·日立丶一丶丿
荀	dwiue·芍日丨ㄋ一一
滢	nwee·氵一一丨一
瘸	ltiuo·疒加丨ㄋ丿丶
纶	xaor·纟仑丿丶丿ㄋ
腆	haorrr·月曲丿丶丶丶
汛	npeii·氵乙一丨丨丨
煦	wkiu·日勹丨ㄋ一丶
屹	yvu·山ㄋㄋㄋㄋ
伎	jpur·亻十ㄋ丶丶丶
仟	jno·亻千丿一丨丨
踞	zze·尸一丨丨ㄋ
蕃	fmiu·艹釆丨ㄋ一丨
骥	azi·马北丨ㄋ一丨
臊	hkiuei·月口丨ㄋ一丨
帛	dyiui·白巾丨ㄋ丨丨
筏	ljeu·亻一ㄋ丿丶
瓮	cjeu·公瓦一ㄋㄋ丶
鳄	dhee·鱼吅一一ㄋㄋ
憬	hwre·忄日丶一丨ㄋ
咫	kkor·尺口丿丶丶丶
溟	nqiue·氵冖丨ㄋ一一
迳	prru·轻辶丶ㄋ丶丶
榄	tliuou·木丨ㄋ丿ㄋ
苞	dgue·芍巳ㄋ一ㄋㄋ
稠	cse·禾冂一丨一丨
椰	tyui·木耳ㄋ丨丨丨
旌	dgoe·𭤨生丿一一丨
俟	jcoe·亻厶丿一一丿
捎	gciu·扌丨ㄋ一一
骰	mdouu·骨殳丿ㄋㄋ丶
迥	skrur·冂口丶ㄋ丶丶
跛	zzu·皮ㄋ丿丨ㄋ
幔	ywiuii·巾日丨ㄋ丨丨
臾	tdorr·臼人丿丶丶丶
刨	kgii·勹巳丨丨丨丨
惬	hve·忄匚一丶丿一
舫	pmr·舟方丶一ㄋ丿
睑	bqrr·目亼丶丶丿一
铿	vmei·钅一丨一一
骋	aaeu·马由一ㄋㄋㄋ
隽	mwuo·隹乃ㄋ丿丿丿
曜	wyo·日羽丿丨丶一
婊	mxouo·女丿ㄋ丿丶
铛	vcue·钅ㄋ一一一
掂	gaie·扌广丨一丨ㄋ
崆	ydeiee·山穴一丨一一
赂	dzou·贝各丿ㄋ丶丨
萼	fheeu·艹吅一一ㄋㄋ
湃	nneee·氵一一一一
黠	xnei·黑吉一丨一丨
咻	kjeio·口亻一丨丿丶
跤	zqo·六丿丶丶丶
冽	wbii·冫歹丨丨丨丨
纨	xgr·纟九丶丶丶丶
唷	kxiue·口丨ㄋ一一
惰	hdei·忄一丨一丨
猖	pwiue·犭日丨ㄋ一一
羿	yneoi·羽廾一丿丨丨
毗	gmeu·田比一ㄋ丿ㄋ
榭	tze·木身一丨丶丶
恣	plr·次心丶ㄋ丶丶
潦	nkro·氵大丶丿丨ㄋ
腋	hboro·月亠丿丶丿ㄋ
呗	kdiuor·口贝丨ㄋ丿丶
褒	bjiu·亠亻丨ㄋ一一
淬	nbor·氵亠丿丶丿丶
哒	kkr·口大丶ㄋ丶丶
蹊	zyuu·爫ㄋㄋ丶一
囱	znee·夂一一一一
袂	hvor·衤丿丶丶丶
胚	hheee·月不一一一一
攸	jnoe·攵丿一丿丶
诲	svu·讠ㄋㄋ丶一
璜	spi·王丨ㄋ一丨
璀	syoi·王山丿丨丶一
峪	yfori·山八丿丶丨ㄋ
藕	fdiuee·艹耒丨ㄋ一一
婵	mhro·女单丶丿丨ㄋ
踝	zwe·日一丨丿丶
盅	vciui·中皿丨ㄋ丨丨
杳	twi·木日丨ㄋ一一
忱	hqou·忄冖丿ㄋㄋㄋ
翌	yhr·羽立丶一丶丿
篆	laouo·彑丿ㄋ丿丿
燎	pkro·火大丶丿丨ㄋ
崛	yzu·山尸ㄋ丨丨ㄋ
濒	nhioo·氵止丨丿丿一
钠	vliu·钅内丨ㄋ丿丶
烨	pyeii·火化一丨丨丨
橄	tteii·木乛一丨丨一
笆	lguieu·巴ㄋ丨一ㄋ
滇	nho·氵直丿丶丶丶
缈	xbio·纟目丨丿丶丿
泾	npure·氵轻ㄋ丶一丨
沓	nwiuee·水日丨ㄋ一一
扈	tkui·户口ㄋ丨一ㄋ
鳌	kdoui·敖鱼丿ㄋ丨ㄋ
睽	byee·目癶一一丿丶
仄	ado·厂人丿丶丶丶
逵	lfeie·土八一丨一丶
禧	haiu·礻壴丨ㄋ一一
卯	pou·卯丿ㄋ丿ㄋ丨
邯	dyui·甘阝ㄋ丨丨丨
霁	pnoi·文丿丨丨丨
贻	dciuee·贝厶丨ㄋ一一
珞	szour·王各丿ㄋ丶丨
坳	lpuo·土幺ㄋ丿丿丿
猥	pgeu·犭田一ㄋ丿丶
杵	tvei·木一丨丨丨
撂	ggou·扌田丿ㄋ丶丨
钙	vjie·钅一丨一ㄋㄋ
盹	bbe·目屯一ㄋ丨ㄋ
淤	nmor·氵方丿丶丶丶
豚	hheo·月豕一丿ㄋ丿
锢	vkeii·钅囗一丨丨ㄋ
蜿	bvour·虫宀丿ㄋ丶ㄋ
酰	tgo·酉先丿一丨一
酝	tmee·酉云一一ㄋ丶
圩	laee·土于一一丨丨
帚	cqi·彐冖丨ㄋ丨丨
蜗	bkiuo·虫口丨ㄋ丿丶
茬	fdeie·艹一丨一一
瞠	bcei·目一丨一一
啬	paiu·十䒑丨ㄋ丨ㄋ
瀛	nyuo·氵赢ㄋ丿一一
腼	hheoi·月面一丿丨ㄋ
蜥	btoo·虫木丿丿一丨
湄	nziu·氵丨ㄋ一一
啾	kcr·口禾丶丿丿丶
拄	gkre·扌主丶一一丨
亘	jqiu·一旦丨ㄋ一一
羲	kceu·禾一ㄋ一ㄋ
篓	lqu·米ㄋ丿一一
坍	lsr·土冂丶一一一
骼	mzou·骨各丿ㄋ丶丨
蚤	fjiuei·又丶丨ㄋ一丨
珈	stuo·王加ㄋ丿丨ㄋ
涮	nziui·氵尸丨ㄋ丨丨
慵	hauee·忄广ㄋ一一丨
孺	speo·孑一丿丨ㄋ
嫖	mte·女覀一一丨丿
踵	zniue·千丨ㄋ一一
聿	sue·聿ㄋ一一一一
衾	qjre·今衣丶一丿ㄋ
蟆	byeii·虫莫一丨丨丨
皋	dkeii·白大一丨丨丨
卞	jleir·丶下一丨丶丶
飓	aheu·几乂一ㄋ一一
翊	hyure·立羽ㄋ丶一ㄋ
闩	fjeee·门一一一一一
脓	hlru·月农丶ㄋ丿ㄋ
镣	vkroi·钅大丶丿丨ㄋ
箕	lgor·其丿丶丶丶
壹	bheiu·豆一丨ㄋ一
呷	kaiue·口甲丨ㄋ一一
溉	nteu·氵一ㄋ丿ㄋ
胄	ahi·由⺝丨ㄋ一一
瑙	swoi·王巛丿丨ㄋ丿
驸	ajeir·马亻一丨丶丶
悖	hbui·忄ㄋ丨一一
馥	cwoe·禾日丿一丨ㄋ
捋	gyei·扌爫一丨丶丶
镕	vdo·钅穴丿丶丨ㄋ
娓	mzoe·女尸丿一一ㄋ
磺	dpiu·石丨ㄋ一丨
苓	fqor·艹令丿丶丶ㄋ
痪	ldiue·疒丨ㄋ一丿
酉	teiu·酉一丨ㄋ丿ㄋ
懵	hwru·忄萝丶ㄋ丨ㄋ
衮	qco·六厶丿ㄋ丿丶
辘	ymr·车鹿丶一丿ㄋ
夙	ab·几歹一丿ㄋ丶
粱	nsor·氵刀丿丶丶丿
宸	vyeo·宀辰一丿一一
姣	mqor·女六丿丶丶丶
汾	nsoru·氵分丿丶ㄋ丿
嫡	mhiue·女丨ㄋ一丨
蘑	fyeo·艹麻一丿丨ㄋ
暨	tniu·旡丨ㄋ一一
檬	twee·木一一丿ㄋ
戊	keo·戊一丿ㄋ丿丶
颌	cneoi·合页一丿丨ㄋ
秧	cseo·禾冂一丿丶丶
璨	slou·王⺊丿ㄋ丶丿
渲	nveiu·氵宀一丨ㄋ一
饷	pziu·饣丨ㄋ一一
咂	kviu·口匚丨ㄋ丨丨
丕	hjee·不一一一一一
赣	mpou·音十丿ㄋ丶一
晟	wku·日戊ㄋㄋㄋㄋ
掬	gkro·扌勹丶丿一丨
遽	dhru·虍豕丶ㄋ丶丶
螂	bjue·虫丶ㄋ一一ㄋ
笈	lsour·及丿ㄋ丶丶
柠	tveii·木宀一丨丨丨
蛰	dbi·执虫丨ㄋ一丨
嚅	kpeoi·口一丿丨ㄋ
蜈	bkee·虫口一一丿丶
痞	lhiu·疒不丨ㄋ一一
荤	wyeu·车一ㄋ一丨
峒	ysei·山冂一丨ㄋ一
咛	kveii·口宀一丨丨丨
蟠	bmi·虫釆丨ㄋ一丨
瞌	bwi·目去丨ㄋ丨丨
汩	nkee·氵囗一一一一
瞑	bqi·目冖丨ㄋ一一
熹	akrr·壴口丶丶丶丶
搪	gaue·扌广ㄋ一一丨
囡	kmuo·囗女ㄋ丿一一
飚	ahro·几乂丶丿丿丶
倌	jviu·亻宀丨ㄋ一ㄋ
恁	jsru·亻壬丶ㄋ丶丶
偃	jviue·亻匚丨ㄋ一一
臧	kkeiu·戊爿一丨ㄋ一
讹	syoio·讠化丿丨丿ㄋ
玷	stie·王占丨一丨ㄋ
戍	kjrrr·戊丶丶丶丶丶
莓	fvu·艹ㄋㄋ丶一
蓟	fdii·艹鱼丨丨丨丨
跚	zsi·冂丨ㄋ一一
龛	cleo·合龙一丿ㄋ丿
俸	jlee·亻一一丨丨
魇	apo·厂犬丿丨ㄋ一
隼	mpei·隹十一丨丨丨
酵	tfui·酉耂ㄋ丨一一
撬	gwoe·扌毛丿一一ㄋ
疵	ltie·疒此丨一丨一
疹	ldoo·疒人丿丿丿丿
泞	nveiii·氵宀一丨丨丨
颚	hyueo·吅二ㄋ一丿丨
蝗	bde·虫白一一丨一
侏	jjeei·亻丿丨丿丶丶
鼾	jgee·自畀一一丨丨
徨	fdeei·彳白一一丨一
翱	dkeiu·白大一丨ㄋ丶
荃	fdeeie·艹人一一丨一
浒	nsoe·氵讠丿一一丨
蘸	fto·艹酉丿丨丶一
臆	hmru·月音丶ㄋ丶丶
噙	kdr·口人丶一丿丶
嗫	kyur·口耳ㄋ丶ㄋ丶
螃	bhreu·虫丶一ㄋ丿
胯	hkeeu·月大一一ㄋㄋ
纫	xsr·纟刀丶丶丶丶
瘴	lmei·疒音一丨丨丨
潼	nhiu·氵立丨ㄋ一一
膺	ajoire·广亻丿丨丶一
磐	pdeo·舟殳一丿丨ㄋ
嘤	kdiuor·口贝丨ㄋ丿丶
啷	kjuee·口丶ㄋ一一ㄋ
劭	skuo·刀口ㄋ丿丿丿
诽	szi·讠非丨一一一
槌	tjiueu·木丿丨ㄋ一ㄋ
抉	gvor·扌丿丶丶丶
剁	atii·几木丨丨丨丨
篝	lpiue·丨ㄋ一丨
瞰	bte·目乛一丨丨一
怆	hdu·忄人ㄋㄋㄋㄋ
酯	tniue·酉匕丨ㄋ一一
堇	yeiie·堇一丨丨一丨
噘	kar·口厂丶丿一ㄋ
蹩	qniue·㡀攵丨ㄋ一丨
蹂	zhe·矛一丨丿丶
馁	pyuo·饣爫ㄋ丿一一
弼	xjo·弓一丿丨ㄋ一
鞑	qkru·革大丶ㄋ丶丶
骁	apeu·马尧一ㄋ丿一
蔗	fdr·艹度丶丶丶丶
樟	tmei·木音一丨丨丨
轶	yjee·车丿一一丿丶
绺	xnir·纟夂丨丶丶丶
篡	lbe·目一丿丶ㄋ
汶	nnreo·氵文丶一丿丶
葆	psiuee·𦫻呆丨ㄋ一一
涓	nkiuee·氵口丨ㄋ一一
氮	vpro·气火丶丿丿丶
谚	sheoo·讠一丿丿丿
蚣	bcoru·虫公丿丶ㄋ丶
掰	nsoee·分丿一一丨
掖	gbor·扌亠丿丶丿ㄋ
蹒	zfeiu·艹一丨ㄋ丿
靥	apeo·厂犬一丿丨ㄋ
熨	zsei·尸示一丨丶丶
憩	njru·舌自丶ㄋ丶丶
亟	ckur·了口ㄋ丶一一
鬃	bveei·髟宀一一丨丿
虱	pji·丿丨ㄋ一丨
晾	wlrei·日京丶一丨ㄋ
垛	laei·土几一丨丿丶
嫔	mvoi·女宀丿丨一丨
鬈	bluu·髟ㄋㄋㄋㄋ
嫦	mciu·女丨ㄋ丨丨
捱	gaeie·扌厂一丨一一
绉	xxou·纟刍丿ㄋㄋ一
彝	aqu·彑米ㄋㄋ丶丨
刽	dmi·人云丨丨丨丨
颦	hceo·止一丿丨ㄋ
嗬	kforei·口艹丿丶一丨
糜	yqro·麻米丶丿一丨
豺	dtei·豸才一丨丿丿
舐	nmou·舌氏丿ㄋ一ㄋ
嬴	ymuoe·赢女ㄋ丿一一
蕨	far·艹厂丶丿一ㄋ
掸	ghro·扌单丶丿丨ㄋ
鳖	qnou·㡀攵丿ㄋ丨ㄋ
羌	kpuuu·乚ㄋㄋㄋㄋ
纣	xjeir·纟寸一丨丶丶
敕	znoeo·束攵丿一丿丶
阉	fkiue·门大丨ㄋ一一
谄	sdoie·讠丿丨一ㄋ
恸	hmuo·忄云ㄋ丿丿丿
娣	mxro·女弟丶丿ㄋ一
鹄	jfour·告鸟丿ㄋ丶ㄋ
艮	hue·艮ㄋ一一ㄋ丿
嗥	kdeor·口白一丿丶一
佃	jgiuei·亻田丨ㄋ一丨
嘭	kaoo·口壴丿丿丿丿
躏	zfr·艹丶丨ㄋ丿
喟	kgiuee·口田丨ㄋ一一
蚌	bxee·虫丰一一一丨
皖	dvee·白宀一一丿ㄋ
娲	mkiuo·女口丨ㄋ丿丶
诩	syu·讠羽ㄋ丶一ㄋ
恪	hzour·忄各丿ㄋ丶丨
蜕	bko·虫𠮦丿ㄋㄋㄋ
樽	tdei·木酋一丨丶丶
腌	hkiuee·月大丨ㄋ一一
俾	jdoiu·亻卑丿丨ㄋ一
娑	nvuo·氵少ㄋ丿一一
坯	lhee·土不一一一一
椿	tliue·木丨ㄋ一一
藐	fdoiu·艹豸丿丨ㄋ一
碴	dtiu·石木丨ㄋ一一
抠	gmeo·扌区一丿丶ㄋ
纂	lbeo·目一丿丶ㄋ
涔	nyor·氵山丿丶丶ㄋ
酮	tseiu·酉冂一丨ㄋ一
诘	sneie·讠吉一丨一丨
杞	tgue·木己ㄋ一ㄋㄋ
昙	wmee·日云一一ㄋ丶
辊	yweu·车日一ㄋ丿ㄋ
芍	djrr·芍丶丶丶丶丶
耘	dme·耒云一一ㄋ丶
烷	pvee·火宀一一丿ㄋ
郢	ksui·口王ㄋ丨丨丨
谩	swiu·讠日丨ㄋ丨丨
褛	hqu·衤米ㄋ丿一一
罔	sar·冂䒑丶一ㄋㄋ
梆	txu·木ㄋ丨丨丨
裟	nvre·氵少丶一丿ㄋ
濡	npeoi·氵一丿丨ㄋ
饯	pkee·饣戋一一ㄋ丿
袈	tjre·加衣丶一丿ㄋ
怂	flrurr·从心丶ㄋ丶丶
谧	sloi·讠心丿丨ㄋ丨
町	gaeii·田丁一丨丨丨
莘	fnrer·艹辛丶一丶丿
芋	faee·艹于一一丨丨
嵇	cxri·禾尢丶丨ㄋ丨
匝	vyiu·匚巾丨ㄋ丨丨
舀	ytoi·爫臼丿丨一ㄋ
宓	vloo·宀心丿丿丿丿
娉	mae·女由一ㄋㄋㄋ
锌	vnrer·钅辛丶一丶丿
湍	nyeoi·氵山一丿丨ㄋ
鸵	fvou·鸟宀丿ㄋㄋㄋ
涸	nkei·氵囗一丨丨ㄋ
孵	pjour·丶丿ㄋ丶丨
沏	nnu·氵七ㄋ丿丿丿
唏	kheo·口乂一丿丨ㄋ
吒	kjeu·口丿一ㄋㄋㄋ
龊	hkie·齿口丨一丿丶
愫	hxu·忄ㄋㄋ丶丨
噼	kbue·口辟ㄋ一丿丨
龌	hzeu·齿尸一ㄋ丶一
闰	fseei·门王一一丨一
橇	twoe·木毛丿一一ㄋ
澹	nhor·氵厃丿丶丶一
徙	fhieo·彳止丨一丿丶
耦	dwiui·耒日丨ㄋ丨一
褴	hliui·衤丨ㄋ丨丨
漳	nmeii·氵音一丨丨丨
镂	vqu·钅米ㄋ丿一一
氟	vxoi·气弓丿丨丨丨
擞	gquo·扌米ㄋ丿一丿
竣	hcoro·立厶丿丶丿ㄋ
殇	bvu·歹ㄋ丿丿丿
痣	llrurr·疒士丶ㄋ丶丶
谪	shiuo·讠丨ㄋ丿丶
脐	hnoi·月文丿丨丨丨
犊	cpur·牜十ㄋ丶丶一
谙	smre·讠音丶一丶丿
皑	dyue·白山ㄋ一ㄋㄋ
渤	nbu·氵ㄋ丨一ㄋ
斫	dqoo·石斤丿丿一丨
泗	nkou·氵口丿ㄋㄋㄋ
蒿	fgi·艹丨ㄋ一一
掇	gfu·扌双ㄋ丶ㄋ丶
淆	nheo·氵㐅一丿丨ㄋ
颉	nneoi·吉页一丿丨ㄋ
釜	lnro·父干丶丿一一
赈	dyeoe·贝辰一丿一一
耷	kyeii·大耳一丨丨一
睐	bwio·目𰀆丨丿丶丶
捍	gwee·扌日一一丨丨
佗	jvou·亻宀丿ㄋㄋㄋ
踊	ztu·甬ㄋ丶丨ㄋ
茴	fxiui·艹回丨ㄋ丨ㄋ
睇	bxro·目弟丶丿ㄋ一
嚏	kbiuei·口丨ㄋ一丨
孢	skue·孑勹ㄋ一ㄋㄋ
媲	mzor·女丿丶一一
荼	fqeio·艹亼一丨丿丶
窈	dpuo·穴幺ㄋ丿丿丿
柒	nneior·氵七一丨丿丶
塾	gsour·孑丿ㄋ丶一
颀	qneoi·斤页一丿丨ㄋ
逅	alru·丶ㄋ丶丶
榈	tfi·木门丨ㄋ一丨
岖	ymeo·山区一丿丶ㄋ
恿	tlru·甬心丶ㄋ丶丶
赊	ddee·贝人一一丨丿
瘁	lbor·疒亠丿丶丿丶
淄	nwiuei·氵巛丨ㄋ一丨
佼	jqor·亻六丿丶丶丶
胫	hpure·月轻ㄋ丶一丨
泷	nleo·氵龙一丿ㄋ丿
耙	dgui·耒巴ㄋ丨一ㄋ
禺	wli·日⽱丨ㄋ丨一
岌	ysou·山及丿ㄋ丶丶
宕	vdeo·宀石一丿丨ㄋ
匍	kfeiue·勹甫一丨ㄋ一
隍	ydee·阝白一一丨一
菠	yzuo·落皮ㄋ丿丨ㄋ
邂	hsoee·角刀丿一一丨
谟	syeiii·讠莫一丨丨丨
汴	njei·氵丶一丨丶丶
咿	kjueeo·口亻ㄋ一一丿
粲	lbur·⺊夕ㄋ丶丶丿
碘	daor·石曲丿丶丶丶
妪	mme·女区一丿丶ㄋ
噫	kmr·口音丶ㄋ丶丶
谆	sgui·讠ㄋ丨一一
羚	kqorr·羊令丿丶丶ㄋ
泯	nqueu·氵民ㄋ一ㄋ一
孀	mpeio·女一丨丿丶
缜	xhor·纟直丿丶丶丶
怏	hseo·忄冂一丿丶丶
鳗	dwiuii·鱼日丨ㄋ丨丨
邝	ayuii·广阝ㄋ丨丨丨
粼	qbe·米夕一ㄋ丨ㄋ
烩	pdeeu·火人一一ㄋ丶
渚	nfeie·氵者一丨一丿
摒	gzr·扌尸丶丿一一
婀	myei·女阝一丨ㄋ一
骠	atee·马覀一一丨丿
獠	pkroi·犭大丶丿丨ㄋ
闫	fpee·门三一一一一
肪	hmre·月方丶一ㄋ丿
翦	ayure·前羽ㄋ丶一ㄋ
蜻	bheeie·虫青一一丨一
戛	dbeu·丆目一ㄋ丿丶
僮	jhiu·亻立丨ㄋ一一
颧	fhoi·艹吅丿丨丶一
赧	cwur·赤卩ㄋ丶丶丶
蠹	bdiu·石丨ㄋ一丨
藜	fco·艹禾丿ㄋㄋㄋ
湮	nteie·氵覀一丨一一
榛	tloe·木丿一丨丿
娆	mpeu·女尧一ㄋ丿一
锹	vcr·钅禾丶丿丿丶
覃	tweii·覀日一丨丨丨
蜴	bwou·虫日丿ㄋ丿丿
鸨	npo·匕十丿ㄋ丶ㄋ
瓯	mjeu·区瓦一ㄋㄋ丶
挲	nvoee·氵少丿一一丨
揄	gqiu·扌亼丨ㄋ一一
巽	ggei·巳巳一丨丨一
楔	txuo·木丰ㄋ丿一丿
壬	soe·壬丿一丨一一
涝	nwuo·氵ㄋ丿丿丿
赡	dhor·贝厃丿丶丶一
荟	fdeeu·艹人一一ㄋ丶
愠	hwiu·忄日丨ㄋ丨丨
啻	hyi·巾丨ㄋ一一
珉	sque·王民ㄋ一ㄋ一
挹	gkui·扌口ㄋ丨一ㄋ
踮	zaie·广丨一丨ㄋ
诌	sxo·讠刍丿ㄋㄋ一
绾	xviu·纟宀丨ㄋ一ㄋ
垠	lhuee·土艮ㄋ一一ㄋ
觞	hvuoo·角ㄋ丿丿丿
谀	stor·讠臼丿丶丶丶
臼	toie·臼丿丨一ㄋ一
呓	kfuu·口艹ㄋㄋㄋㄋ
濂	nar·氵广丶丿一ㄋ
阪	yaur·阝ㄋ丶丶丶
闾	fkiuee·门口丨ㄋ一一
皿	ciui·皿丨ㄋ丨丨一
麝	mze·鹿身一丨丶丶
衢	fbiuee·彳目丨ㄋ一一
濯	nyoir·氵羽丿丨丶一
殓	bqrro·歹亼丶丶丿一
镔	vvoi·钅宀丿丨一丨
郸	hyui·单阝ㄋ丨丨丨
淼	nniu·水水丨ㄋ丿丶
镐	vgi·钅丨ㄋ一一
窕	dxr·穴儿丶一丿丶
昀	wkre·日勹丶一一一
噶	kfi·口艹丨ㄋ一一
贲	pfiuo·十艹丨ㄋ丿丶
霈	pneiu·氵一丨ㄋ丨
柑	tdeii·木甘一丨丨一
镌	vmu·钅隹ㄋ丿丿丿
钾	vaiuee·钅甲丨ㄋ一一
摺	gyoiu·扌羽丿丨ㄋ一
挎	gkeeu·扌大一一ㄋㄋ
辍	yfurur·车双ㄋ丶ㄋ丶
蜃	ybiu·辰虫丨ㄋ一丨
蛆	bbi·虫且丨ㄋ一一
菀	fvour·艹宀丿ㄋ丶ㄋ
弈	pneoi·亦廾一丿丨丨
髭	btie·髟此丨一丨一
蜓	bsur·虫壬ㄋ丶丶丶
洱	nyeii·氵耳一丨丨一
荻	fproo·艹犭丶丿丿丶
骈	aaeo·马䒑一丿丨丨
羟	kpur·轻ㄋ丶一丨
箩	lcou·罒丿ㄋ丶丶
辇	jjeu·夫夫一ㄋ一丨
惇	hguie·忄ㄋ丨一一
邋	wkorur·巛囗丿丶ㄋ丶
坷	lgei·土可一丨ㄋ一
啮	khie·口齿丨一丨一
腴	htorr·月臼丿丶丶丶
楫	tkeii·木口一丨丨一
剐	klii·口内丨丨丨丨
孪	psui·亦子ㄋ丨一一
俪	jce·亻丽一丨ㄋ丶
颍	nneoiu·匕水一丿丨ㄋ
啕	kkoe·口勹丿一一丨
雹	pkueu·勹ㄋ一ㄋㄋ
霾	pdiuee·豸丨ㄋ一一
雉	vmoir·矢隹丿丨丶一
狒	pxue·犭弓ㄋ一ㄋㄋ
匐	kliue·勹丨ㄋ一丨
琨	sweuo·王日一ㄋ丿ㄋ
瘀	lmor·疒方丿丶丶丶
琏	syru·王车丶ㄋ丶丶
峥	ybou·山争丿ㄋㄋ一
哂	kteiu·口西一丨ㄋ丿
铀	vaiuei·钅由丨ㄋ一丨
戌	kjee·戊一一一一一
迩	arrur·尔辶丶ㄋ丶丶
虻	bxre·虫亡丶一ㄋㄋ
瘠	lnor·疒丿丶丨ㄋ
旖	dkeiue·𭤨大一丨ㄋ一
忸	haui·忄丑ㄋ丨一一
阂	fhre·门亥丶一ㄋ丿
籽	qsu·米子ㄋ丨一一
坨	lvou·土宀丿ㄋㄋㄋ
蜚	zbiue·非虫丨ㄋ一丨
榔	tjue·木丶ㄋ一一ㄋ
粽	qvee·米宀一一丨丿
诙	sdr·讠丶丿丿丶
搽	gfore·扌艹丿丶一丨
耆	fniue·耂匕丨ㄋ一一
骊	ace·马丽一丨ㄋ丶
辔	xyuu·纟车ㄋㄋ一丨
琰	spro·王火丶丿丿丶
晔	wyei·日化一丨丨丨
犷	par·犭广丶一丿丿
赳	mbu·走丩ㄋ丨丨丨
谗	swour·讠丿ㄋ丶丶
诠	sdeei·讠人一一丨一
箴	lkei·戊一丨ㄋ一
酗	thui·酉乂ㄋ丨丨丨
菡	fcr·艹了丶一丿丶
蔻	fveeo·艹宀一一丿ㄋ
弑	hteur·乂朩一ㄋ丶一
堑	yqei·车斤一丨一一
浜	nqor·氵丘丿丶丶丶
槁	tgi·木丨ㄋ一一
怩	hzouu·忄尸丿ㄋㄋㄋ
咤	kvoe·口宀丿一ㄋㄋ
佻	jxre·亻儿丶一丿丶
缇	xsiu·纟是丨ㄋ一一
睾	jcei·丿罒一丨一一
垭	lsei·土亚一丨丨丶
卅	jwoi·一川丿丨丨丨
讫	svuu·讠ㄋㄋㄋㄋ
斛	hweii·角⺀一丨丨丨
懋	theio·木矛一丨丿丶
倜	jseie·亻冂一丨一丨
斓	nfeiue·文门一丨ㄋ一
恫	hsei·忄冂一丨ㄋ一
迤	vdr·也丶ㄋ丶丶
淞	ntoru·氵木丿丶ㄋ丶
彗	xxue·丰丰ㄋ一一一
仞	jsrr·亻刀丶丶丶丶
琬	svour·王宀丿ㄋ丶ㄋ
喵	kfiu·口艹丨ㄋ一丨
胴	hseiu·月冂一丨ㄋ一
篙	lgiue·丨ㄋ一一
噔	kyeiue·口癶一丨ㄋ一
鲲	dweu·鱼日一ㄋ丿ㄋ
淅	ntooe·氵木丿丿一丨
殒	bkiuor·歹口丨ㄋ丿丶
嶙	yqour·山米丿ㄋ丶一
鳅	dcr·鱼禾丶丿丿丶
痘	lhei·疒豆一丨ㄋ一
潍	nxoir·氵纟丿丨丶一
泠	nqorr·氵令丿丶丶ㄋ
颏	hneo·亥页一丿丨ㄋ
遢	wyr·日羽丶ㄋ丶丶
腓	hzi·月非丨一一一
洵	nkiuee·氵勹丨ㄋ一一
欤	qjou·与一丿ㄋ丿丶
邺	jyui·业阝ㄋ丨丨丨
蟋	bmr·虫釆丶ㄋ丶丶
螳	bceie·虫一丨一一
饨	pbeui·饣屯一ㄋ丨ㄋ
摈	gvoi·扌宀丿丨一丨
峋	ykiue·山勹丨ㄋ一一
沱	nvouu·氵宀丿ㄋㄋㄋ
谲	shiuor·讠矛丨ㄋ丿丶
诋	smrr·讠氏丶丶丶丶
犄	ckeiu·牜大一丨ㄋ一
泸	nlu·氵⺊ㄋ一丿丿
匮	vliuo·匚丨ㄋ丿丶
屐	zfeiur·尸彳一丨ㄋ丶
呦	kpuo·口幺ㄋ丿丿丿
柩	tvou·木匚丿ㄋ丶丶
龇	htie·齿此丨一丨一
诮	sciue·讠丨ㄋ一一
翳	vvou·匚矢丿ㄋㄋ丶
橹	tdiue·木鱼丨ㄋ一一
嗝	kleiue·口鬲一丨ㄋ一
盥	tniui·水丨ㄋ丨丨
棹	tliuee·木⺊丨ㄋ一一
桧	tdeeu·木人一一ㄋ丶
忤	hvei·忄一丨丨丨
鹞	yyou·爫缶丿ㄋ丶ㄋ
秆	cneei·禾干一一丨丨
鄱	mgui·釆田ㄋ丨丨丨
蹇	hkieo·寒口丨一丿丶
蟀	bbuu·虫亠ㄋㄋ丶丶
蛀	bkr·虫主丶一一丨
剽	tsii·覀示丨丨丨丨
糗	qjeo·米自一丿丶丶
淙	nveei·氵宀一一丨丿
饪	pso·饣壬丿一丨一
绡	xciu·纟丨ㄋ一一
祗	hmrr·礻氏丶丶丶丶
藓	fdro·艹鱼丶丿一一
岷	yqu·山民ㄋ一ㄋ一
钹	vdur·钅ㄋ丶丶丶
钛	vkrrr·钅大丶丶丶丶
抨	gher·扌平一丶丿一
嵘	ywei·山一丨丿丶
馍	pyeiii·饣莫一丨丨丨
婧	mhee·女青一一丨一
遑	dsr·白王丶ㄋ丶丶
俎	fbiuee·从且丨ㄋ一一
苷	fdeii·艹甘一丨丨一
嘹	kkro·口大丶丿丨ㄋ
佞	jyuo·亻二ㄋ丿一一
濠	ngeo·氵一丿ㄋ丿
刍	xou·刍丿ㄋㄋ一一
挝	gjru·扌寸丶ㄋ丶丶
骅	ayei·马化一丨丨丨
窠	dwei·穴日一丨丿丶
咝	kpuue·口ㄋㄋ一一
臃	hbuu·月亠ㄋㄋ丿丿
糠	qaue·米广ㄋ一一丨
馄	pweu·饣日一ㄋ丿ㄋ
斡	xdrr·人丶丶一丨
绶	xyur·纟ㄋ丶丶丶
煲	jsro·亻呆丶丿丿丶
蔺	ffoi·艹门丿丨丶一
弁	cneoii·厶廾一丿丨丨
囗	kiu·囗丨ㄋ一一一
滂	nhre·氵丶一ㄋ丿
兖	qcou·六厶丿ㄋㄋㄋ
鸪	vfou·古鸟丿ㄋ丶ㄋ
聒	ynoei·耳舌丿一丨丨
箸	lfeieo·者一丨一丿
牒	kduei·片廿ㄋ一丨丿
跻	znoi·文丿丨丨丨
豌	hvour·豆宀丿ㄋ丶ㄋ
觊	ygiu·山己丨ㄋ丿ㄋ
牍	kpurr·片十ㄋ丶丶一
栾	ptei·亦木一丨丿丶
忻	hqooe·忄斤丿丿一丨
嗲	klo·口父丿ㄋ丶丿
诳	spee·讠犭一一丨一
俑	jtur·亻甬ㄋ丶丨ㄋ
镁	vkeo·钅一丿丶丶
觎	qhiii·亼⺝丨丨丨ㄋ
胰	hkueu·月大ㄋ一ㄋㄋ
箔	lnoi·氵丿丨ㄋ一
怵	htr·忄木丶丶丶丶
寮	vkroiu·宀大丶丿丨ㄋ
喙	kaouo·口彑丿ㄋ丿丿
劾	hwuoo·亥力ㄋ丿丿丿
焙	phiu·火立丨ㄋ一一
滟	nxou·氵丰丿ㄋㄋ丨
挞	gkru·扌大丶ㄋ丶丶
妤	mhu·女予ㄋ丶ㄋ丨
韭	zjeee·非一一一一一
绦	xneio·纟夂一丨丿丶
猬	pgiue·犭田丨ㄋ一一
灸	tpr·久火丶丿丿丶
鸢	kfour·弋鸟丿ㄋ丶ㄋ
茁	fyui·艹屮ㄋ丨丨丨
潞	nzour·氵丿ㄋ丶丨
揶	gyuii·扌耳ㄋ丨丨丨
鹑	gsouru·孑丿ㄋ丶ㄋ
磬	lzouu·士丿ㄋㄋ丶
氲	vwiui·气日丨ㄋ丨丨
岫	yaiu·山由丨ㄋ一丨
蹶	zar·厂丶丿一ㄋ
膘	htee·月覀一一丨丿
瑁	swiue·王日丨ㄋ一一
氅	csiue·冂丨ㄋ一丿
鹧	dnou·度灬丿ㄋ丶ㄋ
酊	taeii·酉丁一丨丨丨
蜍	bqe·虫亼一丨丿丶
皈	daurr·白ㄋ丶丶丶
汐	nbou·氵夕丿ㄋ丶丶
佚	jjeeo·亻丿一一丿丶
馏	ppiu·饣丨ㄋ一丨
銮	pvor·亦金丿丶一一
辎	ywiue·车巛丨ㄋ一丨
釉	maiu·釆由丨ㄋ一丨
玳	sjeu·王亻一ㄋ丶丶
旎	dzouu·𭤨尸丿ㄋㄋㄋ
叵	vkiuee·匚口丨ㄋ一一
陂	yzuoi·阝皮ㄋ丿丨ㄋ
裱	hxo·衤丿ㄋ丿丶
祛	hweie·礻去一丨一ㄋ
嵬	ysoi·山鬼丿丨ㄋ一
偻	jquo·亻米ㄋ丿一一
漕	njiu·氵一丨ㄋ一丨
呶	kmur·口女ㄋ丶丶丶
鹳	fhoir·艹吅丿丨丶一
蚓	bxii·虫弓丨丨丨丨
黍	cdire·禾人丨丶一丿
顼	sneoiu·王页一丿丨ㄋ
砧	dtie·石占丨一丨ㄋ
弋	keur·弋一ㄋ丶丶丶
咭	knei·口吉一丨一丨
娩	mwou·女丿ㄋㄋㄋ
疡	ltoo·疒㇡丿丿丿丿
疟	lce·疒一ㄋ一一
徇	fkiuee·彳勹丨ㄋ一一
徵	ase·王一一丨一
饕	kwie·口丂丨一ㄋ丿
肛	hleiee·月工一丨一一
吡	kmeu·口比一ㄋ丿ㄋ
玟	snre·王文丶一丿丶
猷	dpeo·酋犬一丿丶丶
啶	kprr·口定丶丶ㄋ一
唁	ksre·口言丶一一一
讴	smeo·讠区一丿丶ㄋ
孑	sui·孑ㄋ丨一一一
姝	mjee·女丿丨丿丶丶
觐	yfiuo·堇见丨ㄋ丿ㄋ
裆	hcue·衤ㄋ一一一
鹗	hyuo·吅二ㄋ丿ㄋ丶
鳝	dkro·鱼羊丶丿一丨
鲈	dlu·鱼⺊ㄋ一丿丿
骛	hnu·矛攵ㄋㄋ一一
痨	lwuo·疒ㄋ丿丿丿
鹂	cfou·丽鸟丿ㄋ丶ㄋ
蠡	ahiu·彑丨ㄋ一丨
畦	gheiee·田圭一丨一一
汞	lniu·工水丨ㄋ丿丶
铰	vqor·钅六丿丶丶丶
钜	vvuee·钅匚ㄋ一一一
胱	hhiro·月光丨丶丿一
悒	hkui·忄口ㄋ丨一ㄋ
鳍	dfou·鱼耂丿ㄋ丨ㄋ
嘁	kkie·口戊丨一一一
蟑	bme·虫音一丨丨丨
秸	cnei·禾吉一丨一丨
栉	tfuii·木艹ㄋ丨丨丨
帏	yjeeu·巾韦一一ㄋ丨
嗑	kwiui·口去丨ㄋ丨丨
诰	sjoe·讠告丿一丨一
橐	bdei·石一丨丿丶
箐	lheei·青一一丨一
泱	nseo·氵冂一丿丶丶
媪	mwiui·女日丨ㄋ丨丨
俚	jgiuee·亻里丨ㄋ一一
黜	xyuiii·黑屮ㄋ丨丨丨
潸	nmiu·氵林丨ㄋ一一
柚	tai·木由丨ㄋ一丨
恹	haeor·忄厂一丿丶丶
绔	xkee·纟大一一ㄋㄋ
囤	kbeui·囗屯一ㄋ丨ㄋ
螭	bqiu·虫㐫丨ㄋㄋ丶
獗	paro·犭厂丶丿一ㄋ
狎	paiue·犭甲丨ㄋ一一
呲	ktie·口此丨一丨一
稹	chor·禾直丿丶丶丶
嫫	myeii·女莫一丨丨丨
韫	jwiui·韦日丨ㄋ丨丨
熵	phiuo·火丨ㄋ丿丶
搡	gfur·扌又ㄋ丶ㄋ丶
懑	nfeiuo·氵艹一丨ㄋ丿
飨	pjor·丿丿丶丶ㄋ
靼	qqi·革旦丨ㄋ一一
赭	cfe·赤者一丨一丿
豢	lheo·豕一丿ㄋ丿
侗	jseiu·亻冂一丨ㄋ一
蚯	bqoi·虫丘丿丨一丨
纾	xhu·纟予ㄋ丶ㄋ丨
孱	zsu·尸子ㄋ丨一ㄋ
驷	akou·马口丿ㄋㄋㄋ
畹	gvou·田宀丿ㄋ丶ㄋ
滓	nvrer·氵宀丶一丶丿
傥	jcou·亻丿ㄋㄋㄋ
骜	kauue·敖马ㄋㄋ一一
礴	dyei·石落一丨ㄋ一
畿	ppeuo·幺幺一ㄋ丿丶
氤	vqi·气因丨ㄋ一丿
掴	gkeei·扌囗一一丨一
俦	jxe·亻一丨丶丶
罹	choi·罒忄丿丨丶一
箝	lgeii·扌一丨丨一
笞	lciu·厶丨ㄋ一一
砥	dmrr·石氏丶丶丶丶
倨	jze·亻尸一丨丨ㄋ
轼	ykeie·车弋一丨一一
缮	xkroe·纟羊丶丿一丨
酚	tsor·酉分丿丶ㄋ丿
荏	psoe·𦫻壬丿一丨一
琮	sve·王宀一一丨丿
椽	taou·木彑丿ㄋ丿丿
夥	wtou·日木丿ㄋ丶丿
圜	kcei·囗罒一丨ㄋ一
钿	vgiu·钅田丨ㄋ一丨
砺	daeu·石厂一ㄋ丿丿
鲶	dqru·鱼今丶ㄋ丶丶
蛐	bai·虫曲丨ㄋ一丨
爿	kui·爿ㄋ丨一丿丿
浃	nwor·氵𰀆丿丶丶丶
诿	scuo·讠禾ㄋ丿一一
祢	haoui·礻尔丿ㄋ丨丿
祚	hzoe·礻乍丿一丨一
仃	jaei·亻丁一丨丨丨
钺	vkeu·钅戉一ㄋㄋ丿
轭	yauu·车厂ㄋㄋㄋㄋ
蓑	fgeo·艹一丿ㄋ丿
葳	fkeu·艹戊一ㄋ丿一
眦	btiei·目此丨一丨一
唑	kfeie·口从一丨一一
魑	sqiuu·鬼㐫丨ㄋㄋ丶
阕	fyeeor·门癶一一丿丶
镫	vyeiu·钅癶一丨ㄋ一
荞	ffoii·艹夭丿丨丨丨
痢	lcii·疒禾丨丨丨丨
獭	pzoui·犭束丿ㄋ丨ㄋ
燧	pweo·火丷一丿ㄋ丿
溧	nteior·氵覀一丨丿丶
饬	pvuo·饣ㄋ丿丿丿
炷	pkre·火主丶一一丨
庾	ato·广臼丿丶丶丶
镍	vjeio·钅自一丨丿丶
遨	krrur·敖辶丶ㄋ丶丶
骞	hauu·寒马ㄋㄋ一一
遛	pgr·田丶ㄋ丶丶
扪	gfri·扌门丶丨ㄋㄋ
裨	hdoiu·衤卑丿丨ㄋ一
摞	gguu·扌田ㄋㄋ丶丨
嗄	kdiuee·口丆丨ㄋ一一
铢	vjee·钅丿丨丿丶丶
喁	kwiuie·口日丨ㄋ丨一
鹘	mfouru·骨鸟丿ㄋ丶ㄋ
馔	pgueu·饣巳ㄋ一ㄋ一
肽	hkrr·月大丶丶丶丶
淖	nliuee·氵⺊丨ㄋ一一
帼	ykee·巾囗一一丨一
婠	mviue·女宀丨ㄋ一ㄋ
榷	tqoir·木冖丿丨丶一
镳	vmr·钅鹿丶丶丶丶
豕	heou·豕一丿ㄋ丿丿
碉	dsei·石冂一丨一丨
荚	fwor·艹𰀆丿丶丶丶
溥	nfeir·氵甫一丨丶丶
咩	kkroe·口羊丶丿一一
僭	jneu·亻旡一ㄋ丿ㄋ
锉	vfei·钅从一丨一一
酩	tbiue·酉夕丨ㄋ一一
蹴	zleo·京一丿ㄋ丶
胛	haiue·月甲丨ㄋ一一
眇	bvio·目少丨丿丶丿
庠	akro·广羊丶丿一一
灏	nwre·氵日丶一丨ㄋ
昶	jtuor·丶㇉ㄋ丿丶丨
揿	gvouo·扌钅丿ㄋ丿丶
翕	cyur·合羽ㄋ丶一ㄋ
罄	lzouur·士丿ㄋㄋ丶
嫚	mwiuii·女日丨ㄋ丨丨
趄	mbiu·走且丨ㄋ一一
醛	tfore·酉艹丿丶一一
蛎	bae·虫厂一ㄋ丿丿
糯	qpeo·米一丿丨ㄋ
溴	njeo·氵自一丿丶丶
幄	yzeu·巾尸一ㄋ丶一
夯	kwuoo·大力ㄋ丿丿丿
傧	jvoi·亻宀丿丨一丨
锏	vfiue·钅门丨ㄋ一一
铣	vgoe·钅先丿一丨一
桠	tseii·木亚一丨丨丶
剜	vbuu·宀夕ㄋㄋ丨丨
佥	qmr·亼丶丶丿一
谥	saor·讠䒑丿丶丨ㄋ
矾	darr·石几丶丶丶丶
忪	hcoru·忄公丿丶ㄋ丶
檄	tdre·木白丶一ㄋ丿
捌	gkuoi·扌口ㄋ丿丨丨
鱿	dxrr·鱼尢丶丶丶丶
锰	vsi·钅子丨ㄋ丨丨
钏	vwoi·钅川丿丨丨丨
哔	kmei·口比一丨丨丨
麋	mqr·鹿米丶丿一丨
肱	hdur·月ㄋ丶丶丶
伧	jduu·亻人ㄋㄋㄋㄋ
烃	ppu·火轻ㄋ丶一丨
湎	nheoi·氵面一丿丨ㄋ
欹	kgou·大可丿ㄋ丿丶
摁	gqrur·扌因丶ㄋ丶丶
庖	akue·广勹ㄋ一ㄋㄋ
鲑	dheie·鱼圭一丨一一
赍	pfr·十从丶ㄋ丨ㄋ
萋	fju·艹一ㄋ一一丨
犒	cgiu·牜丨ㄋ一一
幂	qwe·冖日一丿丶丶
饽	pbui·饣ㄋ丨一一
邈	ddou·豸白丿ㄋ丶ㄋ
螓	bloe·虫丿一丨丿
夔	ajie·䒑自丨一丨一
闳	fdur·门ㄋ丶丶丶
镭	vpi·钅丨ㄋ一丨
泅	nkor·氵囗丿丶丶丶
岬	yaiue·山甲丨ㄋ一一
莅	phr·𦫻立丶一丶丿
箬	lfeo·艹一丿丨ㄋ
珩	sfeei·王彳一一丨丨
牝	cnou·牜匕丿ㄋㄋㄋ
扞	gnee·扌干一一丨丨
荑	fkue·艹大ㄋ一ㄋㄋ
鸷	dfour·执鸟丿ㄋ丶ㄋ
嶂	ymeii·山音一丨丨丨
宥	vdiuee·宀丨ㄋ一一
靛	hpr·青定丶丶ㄋ一
阡	ynoeii·阝千丿一丨丨
邙	xyuiii·亡阝ㄋ丨丨丨
蝼	bqu·虫米ㄋ丿一一
罅	ydor·缶虍丿丶丿一
涪	nhiue·氵立丨ㄋ一一
拮	gnei·扌吉一丨一丨
蘅	ffou·艹彳丿ㄋ丨ㄋ
葶	fgei·艹一丨丨丨
玎	saeii·王丁一丨丨丨
埂	lbei·土更一丨ㄋ一
棂	tcro·木彐丶丿丿丶
挈	xsoe·丰刀丿一一丨
奁	kmeo·大区一丿丶ㄋ
龈	hhue·齿艮ㄋ一一ㄋ
鲫	dtu·鱼ㄋ丨丨丨
踅	mkie·折口丨一丿丶
姮	mji·女一丨ㄋ一一
餮	bdoo·歹人丿丿丿丿
阒	fbe·门目一丿丶丶
鄢	kqrrr·正与丶丶丶丶
逦	crr·丽辶丶ㄋ丶丶
诶	scoe·讠厶丿一一丿
裾	hzei·衤尸一丨丨ㄋ
罂	ddoe·贝贝丿一一丨
粑	qgui·米巴ㄋ丨一ㄋ
稔	cqr·禾今丶ㄋ丶丶
珅	swii·王日丨丨丨丨
痫	lfeio·疒门一丨丿丶
燮	sproo·言火丶丿丿丶
滦	npeio·氵亦一丨丿丶
撷	gneo·扌吉一丿丨ㄋ
啖	kpro·口火丶丿丿丶
厝	apiue·厂龷丨ㄋ一一
蛹	btu·虫甬ㄋ丶丨ㄋ
绌	xyuiii·纟屮ㄋ丨丨丨
氰	vhee·气青一一丨一
楂	tti·木木丨ㄋ一一
咣	khir·口光丨丶丿一
陲	yzo·阝垂丿一丨一
闱	fjeeui·门韦一一ㄋ丨
莆	ffeiu·艹甫一丨ㄋ一
擢	gyoir·扌羽丿丨丶一
弭	xyei·弓耳一丨丨一
邕	wkui·巛口ㄋ丨一ㄋ
荥	wniu·水丨ㄋ丿丶
灞	npeiie·氵一丨丨一
偈	jwou·亻日丿ㄋ丿丶
袤	bhou·亠矛丿ㄋ丿丶
煨	pgee·火田一一一一
轲	ygei·车可一丨ㄋ一
蹰	zaeiu·厂一丨ㄋ一
诨	sqe·讠冖一ㄋ一丨
汨	nwiuee·氵日丨ㄋ一一
擤	gjiu·扌自丨ㄋ一丨
凫	faouu·几丿ㄋㄋㄋ
亓	jjeo·一丌一丿丨丨
箧	lver·匚一丶丿一
睥	bdoi·目卑丿丨ㄋ一
馊	ptiu·饣臼丨ㄋ丶丶
膻	hbiui·月亠丨ㄋ丨ㄋ
缙	xsiue·纟亚丨ㄋ一一
浔	ncei·氵彐一丨丶丶
殁	bdou·歹殳丿ㄋㄋ丶
柘	tdeo·木石一丿丨ㄋ
忝	fcir·天丨丶丶丶
勖	wbu·日目ㄋ丿丿丿
鹌	kwuou·大日ㄋ丿ㄋ丶
锃	vkeei·钅口一一丨一
褓	hjiue·衤亻丨ㄋ一一
瓒	sgo·王先丿一丨一
塆	lpue·亦ㄋ一ㄋㄋ
螫	cniu·赤攵丨ㄋ一丨
峤	yfoii·山夭丿丨丨丨
铬	vzour·钅各丿ㄋ丶丨
葩	fduie·艹白ㄋ丨一ㄋ
纡	xae·纟于一一丨丨
槎	tkeie·木一丨一一
岙	fyiu·夭山丨ㄋ丨丨
姘	maeo·女䒑一丿丨丨
阗	fhor·门直丿丶丶丶
衿	hqorru·衤今丿丶丶ㄋ
纭	xme·纟云一一ㄋ丶
殛	bciue·歹了丨ㄋ一ㄋ
楮	tfe·木者一丨一丿
枸	tkiue·木勹丨ㄋ一一
刎	jnii·勿刂丨丨丨丨
鲛	dqorr·鱼六丿丶丶丶
躅	zco·罒丿ㄋ丨ㄋ
蠊	bar·虫广丶丿一ㄋ
怄	hmeo·忄区一丿丶ㄋ
崴	ykeu·山戊一ㄋ丿一
驽	cau·奴马ㄋㄋ一一
佝	jkiuee·亻勹丨ㄋ一一
襁	hxi·衤弓丨ㄋ一丨
涿	nhrr·氵豕丶丶丶丶
猢	pvou·犭古丿ㄋ一一
楹	twuri·木乃ㄋ丶丨ㄋ
雠	msoi·隹讠丿丨丶一
铆	vpo·钅卯丿ㄋ丿ㄋ
缢	xaori·纟䒑丿丶丨ㄋ
睢	bmo·目隹丿丨丶一
狷	pkiue·犭口丨ㄋ一一
噻	kheie·口寒一丨一一
璎	sdiu·王贝丨ㄋ丿丶
铡	vdii·钅贝丨丨丨丨
疽	lbiuee·疒且丨ㄋ一一
瑭	saue·王广ㄋ一一丨
铄	vpio·钅丨丿丶丶
蔫	fkuer·艹正ㄋ一丶丶
暝	wqi·日冖丨ㄋ一一
喑	kmre·口音丶一丶丿
魍	ssro·鬼冂丶丿一丶
蓼	fyor·艹羽丿丶丿丿
甯	vliue·宀心丨ㄋ一一
啭	kyee·口车一一ㄋ丶
杷	tguie·木巴ㄋ丨一ㄋ
逡	cfour·厶八丿ㄋ丶丶
苜	fbiuee·艹目丨ㄋ一一
羸	ykro·赢羊丶丿一一
嫒	myeo·女一丿ㄋ丶
伉	jbouu·亻亠丿ㄋㄋㄋ
邨	byu·屯阝ㄋ丨丨丨
笏	ljou·勿丿ㄋ丿丿
疣	lxrr·疒尢丶丶丶丶
毂	byou·车丿ㄋㄋ丶
讣	slir·讠卜丨丶丶丶
粕	qdo·米白丿丨ㄋ一
蹉	zkei·一丨一一
跎	zvou·宀丿ㄋㄋㄋ
脍	hdeeu·月人一一ㄋ丶
揆	gyeeo·扌癶一一丿丶
鳃	dgr·鱼田丶ㄋ丶丶
泫	nbuu·氵亠ㄋㄋ丶丶
杓	tkrrr·木勹丶丶丶丶
杈	tfr·木又丶丶丶丶
鳕	dpue·鱼ㄋ一一一
辂	yzou·车各丿ㄋ丶丨
诟	saeiu·讠一丨ㄋ一
蝌	bcrr·虫禾丶丶一丨
獐	pmei·犭音一丨丨丨
桁	tfee·木彳一一丨丨
栎	tpio·木丨丿丶丶
栀	taeu·木一ㄋㄋㄋ
妊	msoe·女壬丿一丨一
隗	ysoiu·阝鬼丿丨ㄋ一
讵	svue·讠匚ㄋ一一一
痔	lleir·疒土一丨丶丶
珣	skiuee·王勹丨ㄋ一一
梏	tjoe·木告丿一丨一
撺	gdiu·扌穴丨ㄋ一丨
苣	fvue·艹匚ㄋ一一一
鏖	mvor·鹿金丿丶一一
诓	svee·讠匚一一丨一
誊	lsre·言丶一一一
抻	gwii·扌日丨丨丨丨
嘣	kyou·口山丿ㄋ一一
铵	vvuoe·钅宀ㄋ丿一一
舂	ltoi·臼丿丨一ㄋ
骧	abi·马亠丨ㄋ一丨
钣	vaur·钅ㄋ丶丶丶
繇	yyouu·爫缶丿ㄋㄋ丶
癣	ldro·疒鱼丶丿一一
瘘	lquo·疒米ㄋ丿一一
榉	tmor·木丿丶一一
彀	bjueu·一ㄋ一ㄋ丿
蕲	fhoo·艹单丿丿一丨
崂	ywuoo·山ㄋ丿丿丿
噌	kwro·口曾丶丿丨ㄋ
锲	vxu·钅丰ㄋ丿丿丿
蚱	bzoe·虫乍丿一丨一
牦	cwoee·牜毛丿一一ㄋ
煊	pveiu·火宀一丨ㄋ一
暹	wmr·日隹丶ㄋ丶丶
懔	hbiuiu·忄亠丨ㄋ丨ㄋ
愆	fneei·彳氵一一丨丶
醮	tmrrr·酉隹丶丶丶丶
笳	ltuo·加ㄋ丿丨ㄋ
趔	mbii·走歹丨丨丨丨
诒	sciuee·讠厶丨ㄋ一一
褡	hfore·衤艹丿丶一丨
羯	kwou·日丿ㄋ丿丶
猱	phei·犭矛一丨丿丶
娠	myeoe·女辰一丿一一
鸶	ppeou·一丿ㄋ丶
芩	fqorr·艹今丿丶丶ㄋ
掮	gtiu·扌户丨ㄋ一一
囿	kdiuee·囗丨ㄋ一一
儆	jfoui·亻艹丿ㄋ丨ㄋ
侩	jdee·亻人一一ㄋ丶
仝	dleiee·人工一丨一一
蛔	bxiu·虫回丨ㄋ丨ㄋ
耄	fnoee·耂匕丿一一ㄋ
琊	saui·王牙ㄋ丨丨丨
恽	hqeu·忄冖一ㄋ一丨
姒	mbur·女以ㄋ丶丿丶
鸩	qx·冖儿丿ㄋ丶ㄋ
醚	tqru·酉米丶ㄋ丶丶
绻	xlu·纟ㄋㄋㄋㄋ
忾	hvoe·忄气丿一一ㄋ
碣	dwouo·石日丿ㄋ丿丶
獒	kpeor·敖犬一丿丶丶
桡	tpeu·木尧一ㄋ丿一
掼	gviu·扌毌丨ㄋ丿丶
囵	kaor·囗仑丿丶丿ㄋ
芪	fmou·艹氏丿ㄋ一ㄋ
箓	lcir·丨丶一丿
牖	kteiue·片户一丨ㄋ一
濛	nweeo·氵一一丿ㄋ
澧	naeiu·氵曲一丨ㄋ一
鳏	dcio·鱼罒丨丿丿丶
菖	fwiue·艹日丨ㄋ一一
苋	ffiu·艹见丨ㄋ丿ㄋ
蒺	floe·艹疒丿一一丿
篑	lliuo·丨ㄋ丿丶
潋	nqr·氵亼丶丶丿一
汜	ngue·氵巳ㄋ一ㄋㄋ
徕	fwio·彳𰀆丨丿丶丶
孬	hmui·不女ㄋ丨一一
唳	kteo·口户一丿丶丶
酡	tvouu·酉宀丿ㄋㄋㄋ
遒	drru·酋辶丶ㄋ丶丶
踯	zaeo·䒑一丿丶ㄋ
苒	fsei·艹冂一丨一一
纰	xmeu·纟比一ㄋ丿ㄋ
祉	hhie·礻止丨一丨一
砷	dwii·石日丨丨丨丨
柢	tmrrrr·木氏丶丶丶丶
哐	kvee·口匚一一丨一
腭	hheeu·月吅一一ㄋㄋ
鬣	bwiu·髟巛丨ㄋ一丿
茛	fhue·艹艮ㄋ一一ㄋ
瑗	syee·王爫一一丿ㄋ
戕	kkeu·爿戈一ㄋ丿丶
愎	hviuee·忄丨ㄋ一一
悌	hxro·忄弟丶丿ㄋ一
呤	kqorru·口令丿丶丶ㄋ
铉	vbuur·钅亠ㄋㄋ丶丶
轸	ydooo·车人丿丿丿丿
觥	hhiroe·角光丨丶丿一
蚪	bwei·虫⺀一丨丨丨
壅	bpoo·亠丿丿丨丶
噱	kdeou·口虍一丿ㄋ丿
阚	fteii·门乛一丨丨一
铤	vsur·钅壬ㄋ丶丶丶
辚	yqoure·车米丿ㄋ丶一
踽	zji·丿丨ㄋ一丨
貉	dzour·豸各丿ㄋ丶丨
谯	smrrr·讠隹丶丶丶丶
佶	jnei·亻吉一丨一丨
魈	sciuee·鬼丨ㄋ一一
葭	fqu·艹叚ㄋ一丨一
瑷	syeou·王一丿ㄋ丶
焖	pfru·火门丶ㄋ丶丶
郜	jyuii·告阝ㄋ丨丨丨
磔	dbeui·石夕一ㄋ丨一
狲	psio·犭孑丨丿丶丶
桎	tgeu·木至一ㄋ丶一
垩	sleiee·亚土一丨一一
牯	cvei·牛古一丨丨ㄋ
沣	nxee·氵丰一一一丨
枇	tmeu·木比一ㄋ丿ㄋ
舸	pgei·舟可一丨ㄋ一
腱	hsur·月聿ㄋ丶丶丶
嫱	mpro·女十丶丿一丨
傣	jlir·亻丨丶一丿
伢	jaeu·亻牙一ㄋ丨丿
舢	pyiui·舟山丨ㄋ丨丨
姹	mvoe·女宀丿一ㄋㄋ
魉	sfo·鬼丙丿丶丿丶
螯	kbiuei·敖虫丨ㄋ一丨
薮	fquo·艹米ㄋ丿一丿
艄	pciuee·舟丨ㄋ一一
廪	abiu·广亠丨ㄋ丨ㄋ
蓁	floei·艹丿一丨丿
缱	xliueu·纟丨ㄋ一ㄋ
篁	ldeei·白一一丨一
桉	tvuo·木宀ㄋ丿一一
杼	thur·木予ㄋ丶ㄋ丨
鸱	mjo·氏丶丿ㄋ丶ㄋ
霰	ppiue·丨ㄋ一一
闼	fkrurr·门大丶ㄋ丶丶
逋	frr·甫辶丶ㄋ丶丶
蒯	fhou·艹月丿ㄋ一一
鹜	hnou·矛攵丿ㄋ丶ㄋ
颢	wleo·日京一丿丨ㄋ
颛	ypeoi·山一丿丨ㄋ
锷	vheeu·钅吅一一ㄋㄋ
钯	vgu·钅巴ㄋ丨一ㄋ
蚜	baeu·虫牙一ㄋ丨丿
奂	dseo·冂一丿丶丶
哞	kcoe·口厶丿一一丨
贽	ddiuo·执贝丨ㄋ丿丶
铳	vxou·钅丿ㄋㄋㄋ
臬	jteio·自木一丨丿丶
墉	laue·土广ㄋ一一丨
埭	lcire·土丨丶一丿
讦	sneeii·讠干一一丨丨
蓿	fvor·艹宀丿丶一丿
硷	dqrr·石亼丶丶丿一
畈	gaurr·田ㄋ丶丶丶
崧	ytor·山木丿丶丶丶
醴	taeiue·酉曲一丨ㄋ一
踟	zviu·矢丨ㄋ一一
赝	ajoire·厂亻丿丨丶一
秣	cde·禾未丨丿丶丶
犟	xkiuei·弓口丨ㄋ一丨
爰	yjeo·爫一一丿ㄋ丶
拊	gjei·扌亻一丨丶丶
僖	jaiue·亻壴丨ㄋ一一
谌	sguu·讠其ㄋㄋㄋㄋ
疱	lkue·疒勹ㄋ一ㄋㄋ
嗵	ktr·口甬丶ㄋ丶丶
乩	tpuuu·占乚ㄋㄋㄋㄋ
鲷	dseie·鱼冂一丨一丨
郦	cyuii·丽阝ㄋ丨丨丨
茏	fleo·艹龙一丿ㄋ丿
磴	dyeiu·石癶一丨ㄋ一
槿	tyeiie·木堇一丨丨一
娌	mgiu·女里丨ㄋ一一
妯	maiue·女由丨ㄋ一丨
鳟	ddei·鱼酋一丨丶丶
盱	baee·目于一一丨丨
冼	wgo·冫先丿一丨一
郴	myu·林阝ㄋ丨丨丨
炔	pvorr·火丿丶丶丶
唿	kjru·口勿丶ㄋ丶丶
蜢	bsi·虫子丨ㄋ丨丨
圻	lqoo·土斤丿丿一丨
卟	klirr·口卜丨丶丶丶
魃	sdur·鬼ㄋ丶丶丶
谡	sgor·讠田丿丶丿ㄋ
俅	jwei·亻求一丨丶一
轾	ygeu·车至一ㄋ丶一
薜	fbue·艹辟ㄋ一丿丨
莒	fkiuee·艹口丨ㄋ一一
砒	dmeu·石比一ㄋ丿ㄋ
烊	pkroe·火羊丶丿一一
搦	gxre·扌弓丶一ㄋ一
齑	nnie·文丨一一一
邳	hjui·不一ㄋ丨丨丨
螟	bqiue·虫冖丨ㄋ一一
徉	fkro·彳羊丶丿一一
陟	yhio·阝止丨丿丿丿
钨	vkue·钅勹ㄋ一一一
蛱	bwor·虫𰀆丿丶丶丶
竽	laeei·于一一丨丨
枞	tforo·木从丿丶丿丶
搴	hnoee·寒手丿一一丨
恚	hlrur·圭心丶ㄋ丶丶
媾	mpi·女丨ㄋ一丨
谔	shee·讠吅一一ㄋㄋ
蚝	bwoee·虫毛丿一一ㄋ
茯	ppeor·𦫻犬一丿丶丶
膑	hvoi·月宀丿丨一丨
硼	dhou·石月丿ㄋ一一
擘	bnoee·辟手丿一一丨
撸	gdiue·扌鱼丨ㄋ一一
悭	hmei·忄一丨一一
幛	ymeiii·巾音一丨丨丨
鬻	xqueue·弓米ㄋ一ㄋ一
阆	fjue·门丶ㄋ一一ㄋ
螨	bfeiu·虫艹一丨ㄋ丿
舛	bjeu·夕㐄一ㄋ丨丨
鳚	dzee·鱼尸一一丨丿
骓	amoi·马隹丿丨丶一
锟	vwe·钅日一ㄋ丿ㄋ
铂	vdoi·钅白丿丨ㄋ一
跖	zdeo·石一丿丨ㄋ
矍	bboir·目目丿丨丶一
邛	lyu·工阝ㄋ丨丨丨
逖	ppru·犭火丶ㄋ丶丶
葺	fkeii·艹口一丨丨一
苄	fjei·艹丶一丨丶丶
眙	bciuee·目厶丨ㄋ一一
湫	ncro·氵禾丶丿丿丶
鼹	twrr·鼠日丶丶ㄋㄋ
癯	lbiuee·疒目丨ㄋ一一
旃	dsre·𭤨冂丶一一一
垸	lveeo·土宀一一丿ㄋ
诤	sbou·讠争丿ㄋㄋ一
蛭	bge·虫至一ㄋ丶一
殚	bhro·歹单丶丿丨ㄋ
邡	myui·方阝ㄋ丨丨丨
跆	zciu·厶丨ㄋ一一
莠	fcuoo·艹禾ㄋ丿丿丿
樾	tmeuu·木走一ㄋㄋ丿
囹	kqorru·囗令丿丶丶ㄋ
啁	kseie·口冂一丨一丨
亳	gjeu·丿一ㄋㄋㄋ
乜	tpuuuu·乚ㄋㄋㄋㄋ
鼬	taiu·鼠由丨ㄋ一丨
羧	kcoro·厶丿丶丿ㄋ
鄞	yyui·堇阝ㄋ丨丨丨
簟	ltiue·覀丨ㄋ一一
瞽	apur·壴十ㄋ丶丨ㄋ
猊	ptou·犭臼丿ㄋㄋㄋ
犸	pauu·犭马ㄋㄋ一一
奘	kleor·爿士一丿丶丶
骢	azo·马丿丶一丶
雒	zmo·各隹丿丨丶一
铧	vyeii·钅化一丨丨丨
缟	xgi·纟丨ㄋ一一
睚	baei·目厂一丨一一
镞	vdoe·钅𭤨丿一一丿
玥	shoue·王月丿ㄋ一一
槊	sheio·屰月一丨丿丶
怫	hxoi·忄弓丿丨丨丨
綦	gduur·其糸ㄋㄋ丶丨
搠	gsoue·扌屰丿ㄋ一一
寤	vkeiu·宀爿一丨ㄋ一
啵	knu·口氵ㄋ丿丨ㄋ
酆	yxe·山丰一一一丨
狯	pdeeur·犭人一一ㄋ丶
湟	ndeeie·氵白一一丨一
徜	fciu·彳丨ㄋ丨ㄋ
醪	tyor·酉羽丿丶丿丿
衩	hfrr·衤又丶丶丶丶
柞	tzoe·木乍丿一丨一
抟	gyurr·扌二ㄋ丶丶丶
俳	jzie·亻非丨一一一
砭	djrurr·石丿丶ㄋ丶丶
淦	nvor·氵金丿丶一一
唢	kciuo·口丨ㄋ丿丶
呋	kjeeo·口夫一一丿丶
黧	ckoi·禾勹丿丨ㄋ丶
茔	wlei·土一丨一一
樨	tzir·木尸丨丶一丿
饴	pciuee·饣厶丨ㄋ一一
衽	hsoei·衤壬丿一丨一
珪	sheie·王圭一丨一一
猡	pco·犭罒丿ㄋ丶丶
猕	pxo·犭弓丿ㄋ丨丿
曷	wkoruu·日勹丿丶ㄋㄋ
轳	ylu·车⺊ㄋ一丿丿
蜇	mbiue·折虫丨ㄋ一丨
缦	xwiu·纟日丨ㄋ丨丨
畲	dsiu·人示丨ㄋ一丨
墀	lzi·土尸丨丶一丿
钤	vqorr·钅今丿丶丶ㄋ
蕖	yveu·落匚一ㄋㄋㄋ
滘	nqore·氵冖丿丶一丨
仨	jpee·亻三一一一一
镛	vaue·钅广ㄋ一一丨
戢	kyeu·口耳一ㄋ丿丶
囫	kjouo·囗勿丿ㄋ丿丿
荩	fkrr·艹尺丶丶丶丶
疝	lyi·疒山丨ㄋ丨丨
猗	pkei·犭大一丨ㄋ一
洮	nxreo·氵儿丶一丿丶
尕	wcio·乃小丨丿丶丶
垟	lkroe·羊丶丿一一
砦	tdeoi·此石一丿丨ㄋ
椴	tgoi·木段丿丨一一
麴	pdou·十人丿ㄋ丶丿
蜮	bkiuee·虫戈丨ㄋ一一
眬	bleo·目龙一丿ㄋ丿
痼	lkeii·疒囗一丨丨ㄋ
痍	lkueu·疒大ㄋ一ㄋㄋ
疥	ldoi·疒人丿丨丨丨
聩	yliuo·耳丨ㄋ丿丶
焘	xjrr·寸丶丶丶丶
滁	nyore·氵阝丿丶一一
沆	nbouu·氵亠丿ㄋㄋㄋ
枰	ther·木平一丶丿一
徼	fdre·彳白丶一ㄋ丿
侪	jnoi·亻文丿丨丨丨
锂	vgiue·钅里丨ㄋ一一
逶	cmr·禾女丶ㄋ丶丶
荠	fnoi·艹文丿丨丨丨
痂	ltuoi·疒加ㄋ丿丨ㄋ
怼	fjru·又寸丶ㄋ丶丶
阍	fmiue·门氏丨ㄋ一一
錾	yqore·车斤丿丶一一
薨	wqeo·萝冖一丿ㄋ丶
缁	xwiue·纟巛丨ㄋ一丨
祜	hveii·礻古一丨丨ㄋ
旄	dwoe·𭤨毛丿一一ㄋ
馗	gaoi·九䒑丿丨ㄋ一
钴	vve·钅古一丨丨ㄋ
菏	ygeiu·落可一丨ㄋ一
嗪	kloe·口丿一丨丿
遴	qbeu·米夕一ㄋ丨丶
诂	svei·讠古一丨丨ㄋ
竦	hzeiu·立束一丨ㄋ一
煅	pgo·火段丿丨一一
樯	tpro·木十丶丿一丨
骝	apiuei·马丨ㄋ一丨
郗	hdiuiu·乂丨ㄋ丨ㄋ
赉	wniuo·𰀆𡭔丨ㄋ丿丶
蝈	bkeei·虫囗一一丨一
薏	fmru·艹音丶ㄋ丶丶
萸	ftor·艹臼丿丶丶丶
菸	fmor·艹方丿丶丶丶
菟	fwour·艹丿ㄋ丶丶
莴	fkiuo·艹口丨ㄋ丿丶
荦	wco·牛丿一一丨
苕	fsiue·艹刀丨ㄋ一一
鹈	xfo·弟鸟丿ㄋ丶ㄋ
萘	fkee·艹大一一丨丿
碜	dcoo·石丿丿丿丿
瘢	lpo·疒舟丿ㄋㄋ丶
晷	wnir·日夂丨丶丶丶
擀	gxor·扌丿丶一一
鹬	hsor·矛冂丿丶丨ㄋ
钡	vdiuo·气贝丨ㄋ丿丶
殄	bdooo·歹人丿丿丿丿
椁	tguiee·木ㄋ丨一一
扃	tsiu·户冂丨ㄋ一一
鞅	qse·革冂一丿丶丶
镊	vyur·钅耳ㄋ丶ㄋ丶
钎	vnoe·钅千丿一丨丨
菅	fviu·艹宀丨ㄋ一ㄋ
肓	xhiue·亡⺝丨ㄋ一一
砀	dto·石㇡丿丿丿丿
墒	lhiue·土丨ㄋ一丨
嚯	kpo·口丿丨丶一
珲	sqeu·王冖一ㄋ一丨
沭	ntrr·氵木丶丶丶丶
刈	hnii·乂刂丨丨丨丨
虢	yjie·爫寸丨一ㄋ丿
膂	djiue·𭤨丨ㄋ一一
缛	xyeir·纟辰一丨丶丶
笄	lneeo·开一一丿丨
岘	yfiuou·山见丨ㄋ丿ㄋ
骐	age·马其一丨丨一
迨	ckrur·厶口丶ㄋ丶丶
苫	ftie·艹占丨一丨ㄋ
穰	cbiu·禾亠丨ㄋ一丨
旯	wgou·日九丿ㄋㄋㄋ
鹕	vhour·古月丿ㄋ丶ㄋ
蚧	bdoii·虫人丿丨丨丨
矞	hsori·矛冂丿丶丨ㄋ
旮	gwiu·九日丨ㄋ一一
旆	djiui·𭤨一丨ㄋ丨丨
屦	zfro·尸彳丶丿一丨
胪	hlue·月⺊ㄋ一丿丿
罴	cwrr·罒去丶丶丶丶
砣	dvou·石宀丿ㄋㄋㄋ
歙	cyouo·合羽丿ㄋ丿丶
婺	hnuo·矛攵ㄋ丿一一
圄	kjiue·囗五丨ㄋ一一
剡	ppii·火火丨丨丨丨
鞣	qheio·革矛一丨丿丶
蓣	fheo·艹予一丿丨ㄋ
荨	fce·艹彐一丨丶丶
洙	njeei·氵丿丨丿丶丶
堞	ldue·土廿ㄋ一丨丿
勐	scuoo·子皿ㄋ丿丿丿
骖	acoo·马丿丿丿丿
铙	vpeu·钅尧一ㄋ丿一
讧	sleiee·讠工一丨一一
臌	haei·月壴一丨ㄋ丶
钲	vkeie·钅正一丨一丨
豸	dorr·豸丿丶丶丿ㄋ
訇	ksree·勹言丶一一一
蚨	bjeeo·虫夫一一丿丶
硐	dseiu·石冂一丨ㄋ一
瑄	sveiu·王宀一丨ㄋ一
沤	nmeo·氵区一丿丶ㄋ
帔	yzuoiu·巾皮ㄋ丿丨ㄋ
垓	lhreu·土亥丶一ㄋ丿
蚋	bliu·虫内丨ㄋ丿丶
爻	hhorr·乂乂丿丶丶丶
渌	ncir·氵丨丶一丿
槭	tkie·木戊丨一一丨
阃	fkeio·门囗一丨丿丶
酢	tzoei·酉乍丿一丨一
薹	fnru·艹吉丶ㄋ一ㄋ
芘	fmeu·艹比一ㄋ丿ㄋ
毵	cwoeeu·彡丿一一ㄋ
蛩	lari·工几丶丨ㄋ一
莜	fjo·艹丿一丿丶
碛	dxi·石丨ㄋ丿丶
夤	bveo·夕宀一丿丶丨
哚	kaeio·口几一丨丿丶
呔	kkrr·口大丶丶丶丶
鲟	dcei·鱼彐一丨丶丶
阊	fwiuee·门日丨ㄋ一一
谶	sfeie·讠从一丨一一
藁	fgiu·艹丨ㄋ一一
稗	cdo·禾卑丿丨ㄋ一
珥	syeiie·王耳一丨丨一
吲	kxii·口弓丨丨丨丨
颞	yfeo·耳双一丿丨ㄋ
镬	vfoi·钅艹丿丨丶一
嵯	ykeiee·山一丨一一
驺	axo·马刍丿ㄋㄋ一
镗	vcei·钅一丨一一
藿	fpoi·艹丿丨丶一
掾	gaouo·扌彑丿ㄋ丿丿
孛	bsui·子ㄋ丨一一
嘬	kwei·口日一丨丨一
鲇	dtiei·鱼占丨一丨ㄋ
邰	ckui·厶口ㄋ丨丨丨
襦	hpeoi·衤一丿丨ㄋ
蕈	ftiu·艹覀丨ㄋ一一
苻	pjei·𦫻寸一丨丶丶
腈	hheeie·月青一一丨一
甾	wgi·巛田丨ㄋ一丨
晗	wqiu·日今丨ㄋ一一
垅	lleou·土龙一丿ㄋ丿
鼍	hgei·吅田一丨ㄋ一
鼋	lkiue·元口丨ㄋ一一
訾	tsr·此言丶一一一
蜉	byui·虫爫ㄋ丨一一
蘩	fvuu·艹ㄋㄋ丶一
舄	tkrrrr·臼勹丶丶丶丶
膈	hleiu·月鬲一丨ㄋ一
疸	lqiue·疒旦丨ㄋ一一
疋	mui·疋ㄋ丨一丿丶
楸	tcroo·木禾丶丿丿丶
髋	mveii·骨宀一丨丨丨
郅	gyuiii·至阝ㄋ丨丨丨
跹	znru·千丶ㄋ丶丶
赅	dhre·贝亥丶一ㄋ丿
蓍	ffoui·艹耂丿ㄋ丨ㄋ
篦	lzor·丿丶一一
窳	dyoo·穴瓜丿丿ㄋ丶
呖	kauo·口厂ㄋ丿丿丿
伥	jboe·亻长丿一ㄋ丶
鹚	apuuro·䒑幺ㄋㄋ丶丿
鸫	ycou·小丿ㄋ丶ㄋ
莼	fxe·艹纟一ㄋ丨ㄋ
筮	llor·工丿丶丿丶
珐	sweie·王去一丨一ㄋ
氐	mjrr·氏丶丶丶丶丶
栊	tleo·木龙一丿ㄋ丿
杲	wteio·日木一丨丿丶
郧	kdui·口贝ㄋ丨丨丨
纥	xvuu·纟ㄋㄋㄋㄋ
屣	zfi·尸彳丨一丨一
郄	hduru·乂ㄋ丶ㄋ丨
赓	acori·广彐丿丶丨ㄋ
脩	jniu·攵丨ㄋ一一
聃	yseie·耳冂一丨一一
碓	dmoi·石隹丿丨丶一
疃	ghiuee·田立丨ㄋ一一
爨	tseiue·冂一丨ㄋ一
泮	njro·氵半丶丿一一
榫	tmeii·木隹一丨丨丨
喱	kaiuee·口厂丨ㄋ一一
傕	jqoi·亻冖丿丨丶一
锗	vfeie·钅者一丨一丿
郓	qyuii·冖车ㄋ丨丨丨
蹼	zjro·业丶丿一一
狻	pcor·犭厶丿丶丿ㄋ
韪	sjeeui·是韦一一ㄋ丨
锆	vjo·钅告丿一丨一
鎏	nxoiu·氵丿丨ㄋㄋ
诎	syui·讠屮ㄋ丨丨丨
瓠	kyuo·大二ㄋ丿丿ㄋ
涫	nviu·氵宀丨ㄋ一ㄋ
帙	yjeeo·巾丿一一丿丶
嶷	ynoee·山匕丿一一丿
埚	lkiuo·土口丨ㄋ丿丶
鳐	dyoee·鱼爫丿一一丨
馐	pkui·饣ㄋ丨一一
豉	hpurrr·豆十ㄋ丶丶丶
苎	fveee·艹宀一一一一
痈	ltou·疒用丿ㄋ一一
怛	hqiuee·忄旦丨ㄋ一一
啉	kmeio·口林一丨丿丶
卮	ajuu·一ㄋㄋㄋㄋ
仵	jvei·亻一丨丨丨
锜	vkeiue·钅大一丨ㄋ一
邾	jdui·丿未ㄋ丨丨丨
茕	wpeii·一丨丨丨
疠	lweuo·疒万一ㄋ丿丿
孳	apuuru·䒑幺ㄋㄋ丶ㄋ
鸬	lzour·⺊尸丿ㄋ丶ㄋ
鲠	dbei·鱼更一丨ㄋ一
趱	mgoe·走先丿一丨一
蘧	fdeo·艹虍一丿ㄋ丿
萏	fdoie·艹丿丨一ㄋ
硒	dteiu·石西一丨ㄋ丿
珰	scue·王ㄋ一一一
獾	pfiue·犭艹丨ㄋ一丨
仡	jvuuu·亻ㄋㄋㄋㄋ
鼙	apuro·壴十ㄋ丶丿丨
黩	xpur·黑十ㄋ丶丶一
谘	spiu·讠次丨ㄋ一一
蠲	afiu·䒑八丨ㄋ丨丨
耋	fneu·耂匕一ㄋ丶一
碇	dprr·石定丶丶ㄋ一
杪	tvio·木少丨丿丶丿
徂	fbiuee·彳且丨ㄋ一一
塍	hleiee·月一丨一一
蝮	bviu·虫丨ㄋ一一
虺	jxiu·一儿丨ㄋ一丨
蕤	fhoe·艹豕丿一一丨
菽	flio·艹上丨丿丶ㄋ
耒	deee·耒一一一丨丿
檗	btei·辟木一丨丿丶
橼	txuu·木纟ㄋㄋ一丿
柰	tseeio·木示一一丨丿
垆	llu·土⺊ㄋ一丿丿
阄	fdiuee·门丨ㄋ一一
跗	zjei·亻一丨丶丶
觯	hhroiu·角单丶丿丨ㄋ
菰	fsoo·艹孑丿丿ㄋ丶
艉	pzoe·舟尸丿一一ㄋ
缃	xvei·纟相一丨丿丶
篾	lceo·罒一丿ㄋ丿
瀣	nlou·氵⺊丿ㄋ丶ㄋ
扦	gnoeii·扌千丿一丨丨
圉	klro·囗土丶丿一一
凼	nsui·水凵ㄋ丨丨丨
麈	mkre·鹿主丶一一丨
迓	arrurr·牙辶丶ㄋ丶丶
赀	tdiuor·此贝丨ㄋ丿丶
翮	lyur·鬲羽ㄋ丶一ㄋ
禳	hbiue·礻亠丨ㄋ一丨
痤	lfeiee·疒从一丨一一
甑	wjeu·曾瓦一ㄋㄋ丶
愍	qnru·民攵丶ㄋ丶丶
彧	kkeo·弋口一丿丿丿
餍	apor·厂犬丿丶丶ㄋ
襞	bjre·辟衣丶一丿ㄋ
縻	ydu·麻糸ㄋㄋ丶丨
秾	clru·禾农丶ㄋ丿ㄋ
淝	nhui·氵月ㄋ丨一ㄋ
氖	vwuoo·气乃ㄋ丿丿丿
兕	hxou·凹儿丿ㄋㄋㄋ
锑	vxr·钅弟丶丿ㄋ一
邗	nyuii·干阝ㄋ丨丨丨
谵	shorr·讠厃丿丶丶一
裢	hyr·衤车丶ㄋ丶丶
犍	csur·牜聿ㄋ丶丶丶
欷	hdiuio·乂丨ㄋ丨丿
晞	wheo·日乂一丿丨ㄋ
彘	ano·彑匕丿一一丿
帻	yxiu·巾丨ㄋ丿丶
钒	varr·钅几丶丶丶丶
醍	tsiue·酉是丨ㄋ一一
跸	zmei·比一丨丨丨
漯	nguur·氵田ㄋㄋ丶丨
洄	nxiui·氵回丨ㄋ丨ㄋ
庑	ajeo·广一一丿ㄋㄋ
坼	lqrr·土斤丶丶丶丶
哓	kpeu·口尧一ㄋ丿一
踬	zaeii·一丨丨ㄋ
褊	htiu·衤户丨ㄋ一丨
腩	hpiur·月十丨ㄋ丶丿
脲	hziu·月尸丨ㄋ丿丶
缬	xneo·纟吉一丿丨ㄋ
纛	xveu·母一ㄋ一一
痿	lcuo·疒禾ㄋ丿一一
坩	ldei·土甘一丨丨一
圪	lvuu·土ㄋㄋㄋㄋ
嘧	kvru·口宀丶ㄋ丶丿
麸	xneeo·夂一一丿丶
隈	ygeuo·阝田一ㄋ丿丶
锱	vwiue·钅巛丨ㄋ一丨
蠃	ybiue·赢虫丨ㄋ一丨
蛉	bqor·虫令丿丶丶ㄋ
蓖	fzor·艹丿丶一一
糅	qheior·米矛一丨丿丶
柙	taiue·木甲丨ㄋ一一
昴	wpou·日卯丿ㄋ丿ㄋ
慝	vfeor·匚艹一丿丶ㄋ
嬛	mce·女罒一丨ㄋ一
鲱	dzi·鱼非丨一一一
锨	vqou·钅斤丿ㄋ丿丶
趺	zjeeo·夫一一丿丶
荜	fmeii·艹比一丨丨丨
艏	paoi·舟䒑丿丨ㄋ一
箜	ldeie·穴一丨一一
狺	psre·犭言丶一一一
燠	pzr·火丶丿一丨
汊	nfrr·氵又丶丶丶丶
戗	dgeuo·人一ㄋ丿丶
坻	lmrr·土氏丶丶丶丶
圮	lgue·土己ㄋ一ㄋㄋ
儋	jho·亻厃丿丶丶一
龋	hjiuei·齿丿丨ㄋ一丨
龃	hbiuee·齿且丨ㄋ一一
飧	bpor·夕食丿丶丶ㄋ
郯	ppui·火火ㄋ丨丨丨
詈	csr·罒言丶一一一
缯	xwr·纟曾丶丿丨ㄋ
缗	xqi·纟民丨ㄋ一一
筇	llui·工ㄋ丨丨丨
瓤	bheeii·亠吅一一丨丨
溷	nkeo·氵囗一丿ㄋ丿
涞	nwio·氵𰀆丨丿丶丶
堀	lzui·土尸ㄋ丨丨ㄋ
龅	hkueuu·齿勹ㄋ一ㄋㄋ
骶	mmrr·骨氏丶丶丶丶
锴	vmoiu·钅比丿丨ㄋ一
醐	tvoue·酉古丿ㄋ一一
蘖	fjiueu·艹丿丨ㄋ一ㄋ
篌	lju·亻ㄋ一丿一
玕	sneeii·王干一一丨丨
焯	pliu·火⺊丨ㄋ一一
枳	tko·木口丿丶丶丶
昝	nliuee·夂卜丨ㄋ一一
悱	hzie·忄非丨一一一
岿	ynu·山ㄋ一一一
嗐	kveee·口宀一一一丨
龉	hjiuee·齿五丨ㄋ一一
莪	fwoe·艹我丿一丨一
绂	xdurr·纟ㄋ丶丶丶
笥	ltei·一丨ㄋ一
祐	hdiuee·礻丨ㄋ一一
硌	dzouri·石各丿ㄋ丶丨
砝	dweie·石去一丨一ㄋ
燔	pmiu·火釆丨ㄋ一丨
湜	nsiu·氵是丨ㄋ一一
洌	nbii·氵歹丨丨丨丨
戆	mpour·音十丿ㄋ丶一
徭	fyoe·彳爫丿一一丨
哌	kaouor·口丿ㄋ丿丶
偾	jpei·亻十一丨丨丨
伛	jme·亻区一丿丶ㄋ
髂	mvou·骨宀丿ㄋ丶丨
隳	ydeieo·阝一丨一丿
铩	vhei·钅乂一丨丿丶
荇	ffee·艹彳一一丨丨
篪	laie·丨一ㄋ丿
眄	bku·目正ㄋㄋㄋㄋ
炆	pnre·火文丶一丿丶
棻	fseio·艹分一丨丿丶
栲	tfeu·木耂一ㄋㄋㄋ
暾	wgu·日ㄋ丨一丿
黢	xco·黑厶丿丶丿ㄋ
鳉	dzoure·鱼丬丿ㄋ丶一
铋	vlooo·钅心丿丿丿丿
裎	hkeei·衤口一一丨一
莳	fwei·艹日一丨丶丶
芨	fsour·艹及丿ㄋ丶丶
窨	dmre·穴音丶一丶丿
瘿	ldiuor·疒贝丨ㄋ丿丶
渑	nkiuee·氵口丨ㄋ一一
氦	vhre·气亥丶一ㄋ丿
橛	tar·木厂丶丿一ㄋ
樗	tpee·木一一ㄋㄋ
怙	hveiiu·忄古一丨丨ㄋ
侑	jdiue·亻丨ㄋ一一
蹚	zce·一丨一一
趿	zso·及丿ㄋ丶丶
蝣	bdui·虫𭤨ㄋ丨一一
苴	fbiuee·艹且丨ㄋ一一
脔	plo·亦内丿丶丶丶
纮	xdurrr·纟ㄋ丶丶丶
麂	maouu·鹿几丿ㄋㄋㄋ
鲀	dbeuiu·鱼屯一ㄋ丨ㄋ
镝	vhiu·钅丨ㄋ一丨
轱	ypi·车十丨ㄋ一一
觜	thouo·此角丿ㄋ丿ㄋ
螅	bjrur·虫自丶ㄋ丶丶
芗	fpoo·艹丿丿丿丿
矽	dbou·石夕丿ㄋ丶丶
矸	dnee·石干一一丨丨
瞵	bqour·目米丿ㄋ丶一
疖	lwui·疒卩ㄋ丨丨丨
玢	ssor·王分丿丶ㄋ丿
愀	hcro·忄禾丶丿丿丶
髡	bjo·髟一丿ㄋㄋㄋ
镒	vaor·钅䒑丿丶丨ㄋ
貔	dzor·豸丿丶一一
褫	haieu·衤丨一ㄋ丿
缣	xyr·纟兼丶丿一ㄋ
筲	lciue·丨ㄋ一一
椋	tlre·木京丶一丨ㄋ
撄	gdiuo·扌贝丨ㄋ丿丶
崃	ywio·山𰀆丨丿丶丶
傈	jteior·亻覀一丨丿丶
黼	jqoe·业㡀丿一丿丶
陉	ypure·阝轻ㄋ丶一丨
铱	vjr·钅衣丶一丿ㄋ
醢	tdiuei·酉丨ㄋ一丨
蹓	zpiu·丨ㄋ一丨
蓊	fcur·艹公ㄋ丶一ㄋ
翥	ffeie·者者一丨一丿
秭	cxrou·禾弟丶丿ㄋ一
疴	lgeiu·疒可一丨ㄋ一
槲	thrr·木角丶丶一丨
曩	wbiue·日亠丨ㄋ一丨
嘞	kquo·口革ㄋ丿丿丿
陬	yyur·阝耳ㄋ丶丶丶
趸	wkie·万口丨一丿丶
绀	xdei·纟甘一丨丨一
稞	cwei·禾日一丨丿丶
砑	daeui·石牙一ㄋ丨丿
檠	dkoeor·芍口丿一丿丶
槃	pdei·舟殳一丨丿丶
桷	thouou·木角丿ㄋ丿ㄋ
嵴	ynor·山丿丶丨ㄋ
崮	ykeii·山囗一丨丨ㄋ
嬖	bmu·辟女ㄋ丿一一
喆	nneie·吉吉一丨一丨
雩	pyuu·二ㄋㄋㄋㄋ
钼	vbiuee·钅目丨ㄋ一一
醯	txoi·酉丿丨ㄋ丨
胝	hmrrr·月氏丶丶丶丶
盍	wciu·去皿丨ㄋ丨丨
璟	swr·王日丶一丨ㄋ
溘	nwiui·氵去丨ㄋ丨丨
枥	tauo·木厂ㄋ丿丿丿
屌	zkiu·尸口丨ㄋ丨丨
嬗	mbiui·女亠丨ㄋ丨ㄋ
垌	lseiu·土冂一丨ㄋ一
坭	lzouuu·土尸丿ㄋㄋㄋ
哙	kdee·口人一一ㄋ丶
倥	jdeie·亻穴一丨一一
髁	mwe·骨日一丨丿丶
酹	tyeir·酉爫一丨丶丶
郏	wdui·𰀆人ㄋ丨丨丨
贶	dkou·贝口丿ㄋㄋㄋ
芫	flou·艹元丿ㄋㄋㄋ
罍	ggiue·田田丨ㄋ一丨
絷	dduu·执糸ㄋㄋ丶丨
絜	xsu·丰刀ㄋㄋ丶丨
穑	cpro·禾十丶丿一丨
祇	hmou·礻氏丿ㄋ一ㄋ
碚	dhiue·石立丨ㄋ一一
瘗	lwor·疒𰀆丿丶一丨
琚	sze·王尸一丨丨ㄋ
珙	spei·王共一丨丨一
枋	tmre·木方丶一ㄋ丿
帑	cyi·奴巾丨ㄋ丨丨
鳜	daro·鱼厂丶丿一ㄋ
飏	ahuo·几乂ㄋ丿丿丿
酲	tkeei·酉口一一丨一
觚	hyoou·角瓜丿丿ㄋ丶
砬	dhrer·石立丶一丶丿
皤	dmiu·白釆丨ㄋ一丨
犴	pneei·犭干一一丨丨
澍	naeir·氵壴一丨丶丶
歃	ntou·千臼丿ㄋ丿丶
楝	tzr·木束丶丶丶丶
摭	gdrr·扌度丶丶丶丶
尻	zgo·尸九丿ㄋㄋㄋ
鲽	dduei·鱼廿ㄋ一丨丿
鬯	hnui·㐅灬ㄋ丨丿ㄋ
雎	bmoi·且隹丿丨丶一
貅	djei·豸亻一丨丿丶
裥	hfiue·衤门丨ㄋ一一
蝾	bweio·虫一丨丿丶
葑	fheir·艹圭一丨丶丶
箪	lhro·单丶丿丨ㄋ
笤	lsiu·刀丨ㄋ一一
窣	dbor·穴亠丿丶丿丶
皴	cfouru·厶八丿ㄋ丶ㄋ
毳	wwoe·毛毛丿一一ㄋ
廛	agor·广里丿丶一丨
鬲	leiu·鬲一丨ㄋ一丨
髫	bsiu·髟刀丨ㄋ一一
逑	wrrur·求辶丶ㄋ丶丶
蹀	zdue·廿ㄋ一丨丿
诜	sgoe·讠先丿一丨一
謇	hsre·寒言丶一一一
蠖	bfo·虫艹丿丨丶一
蝽	bliue·虫丨ㄋ一一
蚬	bfiu·虫见丨ㄋ丿ㄋ
腚	hprr·月定丶丶ㄋ一
沔	nkuu·氵正ㄋㄋㄋㄋ
塬	laoi·土厂丿丨ㄋ一
黥	xlre·黑京丶一丨ㄋ
麇	mco·鹿禾丿一丨丿
鲙	ddeeu·鱼人一一ㄋ丶
蚴	bpuo·虫幺ㄋ丿丿丿
缫	xwiuee·纟巛丨ㄋ一一
癔	lmru·疒音丶ㄋ丶丶
溲	ntiur·氵臼丨ㄋ丶丶
刳	kyuii·大二ㄋ丨丨丨
鳎	dwur·鱼日ㄋ丶一ㄋ
鲭	dheei·鱼青一一丨一
髀	mdoiu·骨卑丿丨ㄋ一
颡	ffeio·又双一丨丿丶
锒	vju·钅丶ㄋ一一ㄋ
觇	tfiu·占见丨ㄋ丿ㄋ
蘼	fyie·艹麻丨一一一
茭	fqorrr·艹六丿丶丶丶
肄	nvuee·匕矢ㄋ一一一
禊	hxuo·礻丰ㄋ丿一丿
炝	pduu·火人ㄋㄋㄋㄋ
棰	tzoeie·木垂丿一丨一
旒	dxoi·𭤨丿丨ㄋㄋ
垡	jkeie·亻戈一丨一一
喹	kkeiee·口大一丨一一
匏	kyuou·大二ㄋ丿ㄋㄋ
鼐	wbue·乃目ㄋ一丿丨
鹪	mno·隹灬丿ㄋ丶ㄋ
鲧	dju·鱼丿ㄋㄋ丶丨
髌	mvoie·骨宀丿丨一丨
骀	aciu·马厶丨ㄋ一一
颙	wleoi·日⽱一丿丨ㄋ
鞫	qkre·革勹丶一一一
菹	ybiuee·落且丨ㄋ一一
苡	fbur·艹以ㄋ丶丿丶
芰	fpurr·艹十ㄋ丶丶丶
祆	hfoeo·礻夭丿一丿丶
硖	dwor·石𰀆丿丶丶丶
獬	phuoo·犭角ㄋ丿丿一
柽	tfei·木又一丨一一
厍	ayeu·厂车一ㄋ一丨
鲵	dtou·鱼臼丿ㄋㄋㄋ
觌	ptrr·十乛丶丶一丿
螈	baoi·虫厂丿丨ㄋ一
蒡	fhreu·艹丶一ㄋ丿
芡	faouo·艹欠丿ㄋ丿丶
胼	haeoi·月䒑一丿丨丨
糁	qcoo·米丿丿丿丿
瘙	lfr·疒又丶丨ㄋ一
畚	cgiue·田丨ㄋ一丨
泺	npio·氵丨丿丶丶
棼	msor·林分丿丶ㄋ丿
杌	tjou·木一丿ㄋㄋㄋ
曛	wniur·日千丨ㄋ丶丿
捽	gboro·扌亠丿丶丿丶
幪	ywee·巾一一丿ㄋ
巯	pxoi·轻丿丨ㄋㄋ
妁	mkrr·女勹丶丶丶丶
堠	ljue·土亻ㄋ一丿一
埒	lyei·土爫一丨丶丶
鲆	dher·鱼平一丶丿一
谮	sneu·讠旡一ㄋ丿ㄋ
褰	hjre·寒衣丶一丿ㄋ
裰	hfu·衤双ㄋ丶ㄋ丶
葸	fgr·艹田丶ㄋ丶丶
萜	fyiei·艹巾丨一丨ㄋ
罟	cveii·罒古一丨丨ㄋ
瓴	qjeu·令瓦一ㄋㄋ丶
湲	nyee·氵爫一一丿ㄋ
榧	tvie·木匚丨一一一
桴	tyuie·木爫ㄋ丨一一
吖	kwiii·口丷丨丨丨丨
鳢	daei·鱼曲一丨ㄋ一
骘	yhioo·阝止丨丿丿ㄋ
馑	pyeiie·饣堇一丨丨一
镏	vpiu·钅丨ㄋ一丨
跂	zpu·十ㄋ丶丶丶
谰	sfeiu·讠门一丨ㄋ一
蓐	fyeir·艹辰一丨丶丶
茆	fpou·艹卯丿ㄋ丿ㄋ
艽	fgo·艹九丿ㄋㄋㄋ
砻	ldeo·龙石一丿丨ㄋ
湓	nsiui·氵分丨ㄋ丨丨
椹	tguu·木其ㄋㄋㄋㄋ
柝	tqrr·木斤丶丶丶丶
暌	wyeeo·日癶一一丿丶
峄	yfeei·山又一一丨丨
岈	yaeui·山牙一ㄋ丨丿
劬	kkuo·勹口ㄋ丿丿丿
饩	pvoe·饣气丿一一ㄋ
饧	ptooo·饣㇡丿丿丿丿
鞯	qfeo·革艹一丿丨ㄋ
镉	vlei·钅鬲一丨ㄋ一
锕	vyeiue·钅阝一丨ㄋ一
醅	thiue·酉立丨ㄋ一一
酽	tsooo·酉亚丿丿丿丿
鄣	mpui·音十ㄋ丨丨丨
轫	ysr·车刀丶丶丶丶
踣	zhiue·立丨ㄋ一一
跣	zgoe·先丿一丨一
虿	wbiuei·万虫丨ㄋ一丨
蒹	fyro·艹兼丶丿一ㄋ
芟	fdouu·艹殳丿ㄋㄋ丶
芎	fxu·艹弓ㄋ一ㄋㄋ
舁	tneo·臼廾一丿丨丨
粳	qbei·米更一丨ㄋ一
筌	ldeeie·人一一丨一
禛	hhorrr·礻直丿丶丶丶
毽	wsur·毛聿ㄋ丶丶丶
怍	hzoei·忄乍丿一丨一
孥	csui·奴子ㄋ丨一一
妣	mmeu·女比一ㄋ丿ㄋ
埝	lqru·土今丶ㄋ丶丶
刖	hniii·月刂丨丨丨丨
鲳	dwiuee·鱼日丨ㄋ一一
饫	pfoe·饣夭丿一丿丶
赜	qxi·丨ㄋ丿丶
舻	plu·舟⺊ㄋ一丿丿
膦	hqour·月米丿ㄋ丶一
罘	cheoi·罒不一丿丨丶
磻	dmiue·石釆丨ㄋ一丨
痧	lnio·疒氵丨丿丶丿
燊	pproor·火火丶丿丿丶
氩	vseii·气亚一丨丨丶
榇	theior·木立一丨丿丶
捩	gteo·扌户一丿丶丶
埕	lkeei·土口一一丨一
圯	lgueu·土巳ㄋ一ㄋㄋ
鲉	daiu·鱼由丨ㄋ一丨
鲂	dmreu·鱼方丶一ㄋ丿
阏	fmorr·门方丿丶丶丶
铖	vkuu·钅戊ㄋㄋㄋㄋ
钚	vheoi·钅不一丿丨丶
辏	yleeo·车一一丿丶
蟊	hbiuei·矛虫丨ㄋ一丨
藨	fmrrr·艹鹿丶丶丶丶
蒴	fsoue·艹屰丿ㄋ一一
莨	fjuee·艹丶ㄋ一一ㄋ
苾	floo·艹心丿丿丿丿
硚	dfoi·石夭丿丨丨丨
眚	gbiuee·生目丨ㄋ一一
狍	pkueuu·犭勹ㄋ一ㄋㄋ
煸	ptiue·火户丨ㄋ一丨
溏	naue·氵广ㄋ一一丨
湔	naro·氵前丶丿一丨
殂	bbiu·歹且丨ㄋ一一
摽	gtee·扌覀一一丨丿
埽	lcr·土彐丶ㄋ丨ㄋ
垴	lqre·土㐫丶一丿丶
嘏	vque·古叚ㄋ一丨一
呣	kvu·口母ㄋㄋ丶一
骎	acr·马彐丶ㄋㄋ丶
铍	vzuo·钅皮ㄋ丿丨ㄋ
铊	vvouu·钅宀丿ㄋㄋㄋ
酐	tneei·酉干一一丨丨
蛄	bvei·虫古一丨丨ㄋ
缑	xju·纟亻ㄋ一丿一
縠	bjuu·一ㄋㄋ丶丨
籴	dqro·入米丶丿一丨
笪	lqiuee·旦丨ㄋ一一
窅	dbiu·穴目丨ㄋ一一
玠	sdoii·王人丿丨丨丨
旻	wnre·日文丶一丿丶
拶	gwourr·扌巛丿ㄋ丶丶
悛	hcorou·忄厶丿丶丿ㄋ
怿	hfee·忄又一一丨丨
嵊	ycie·山禾丨一一丿
佤	jjeuu·亻瓦一ㄋㄋ丶
黾	kwuuu·口日ㄋㄋㄋㄋ
馕	pbiuei·饣丨ㄋ一丨
郃	cyuiii·合阝ㄋ丨丨丨
遘	psei·冂一丨一丶
辋	ysro·车冂丶丿一丶
蜊	bcii·虫禾丨丨丨丨
蔌	fzouo·艹束丿ㄋ丿丶
荛	fpeu·艹尧一ㄋ丿一
翛	jnu·夂ㄋ丶一ㄋ
缒	xjiue·纟丿丨ㄋ一ㄋ
绐	xciue·纟厶丨ㄋ一一
糨	qxiu·米弓丨ㄋ一丨
祧	hxre·礻儿丶一丿丶
瑱	shorrr·王直丿丶丶丶
狨	pkeo·犭戈一丿丿丿
炅	wproo·日火丶丿丿丶
洹	njiue·氵一丨ㄋ一一
愦	hliuor·忄丨ㄋ丿丶
悫	baru·几丶ㄋ丶丶
屙	zyeiu·尸阝一丨ㄋ一
媵	hluo·月ㄋ丿一一
妫	mjuo·女丶ㄋ丿丶丶
埙	lkiuor·土口丨ㄋ丿丶
叻	kwuooo·口力ㄋ丿丿丿
鸮	kwour·口丂丿ㄋ丶ㄋ
鲢	dyru·鱼车丶ㄋ丶丶
隰	ywuu·阝日ㄋㄋ丶丶
阼	yzoe·阝乍丿一丨一
阋	ftou·门臼丿ㄋㄋㄋ
逄	njrur·夂㐄丶ㄋ丶丶
诔	sdeee·讠耒一一一丨
蛳	bneiu·虫一丨ㄋ丨
菘	ftorr·艹木丿丶丶丶
缶	yoe·缶丿一一丨ㄋ
祓	hdurr·礻ㄋ丶丶丶
碁	gdeoi·其石一丿丨ㄋ
砼	ddeie·石人一丨一一
睃	bcoro·目厶丿丶丿ㄋ
甙	kdei·弋甘一丨丨一
猁	pcii·犭禾丨丨丨丨
狴	pmeie·犭比一丨一一
犇	ccoe·牛牛丿一一丨
炘	pqoo·火斤丿丿一丨
浥	nkui·氵口ㄋ丨一ㄋ
椤	tcou·木罒丿ㄋ丶丶
柁	tvouuu·木宀丿ㄋㄋㄋ
崤	yheo·山㐅一丿丨ㄋ
崄	yqrr·巾亼丶丶丿一
娈	pmuo·亦女ㄋ丿一一
圹	lare·土广丶一丿丿
嘌	kteei·口覀一一丨丿
勰	wwuoi·力力ㄋ丿丨ㄋ
偬	jjrru·亻勿丶丶ㄋ丶
鸹	nfou·舌鸟丿ㄋ丶ㄋ
铌	vzouu·钅尸丿ㄋㄋㄋ
郫	dyuii·卑阝ㄋ丨丨丨
轺	ysi·车刀丨ㄋ一一
裣	hqrr·衤亼丶丶丿一
茀	fxoi·艹弓丿丨丨丨
苌	fboe·艹长丿一ㄋ丶
舨	paur·舟ㄋ丶丶丶
箨	lgur·扌ㄋ丶一一
窭	dqu·穴米ㄋ丿一一
桄	thir·木光丨丶丿一
昃	wao·日厂丿丶丶丶
戡	gpeuo·其乚一ㄋ丿丶
廨	ahuoo·广角ㄋ丿丿一
妗	mqorr·女今丿丶丶ㄋ
垱	lcuee·ㄋ一一一
囷	kcoei·囗禾丿一丨丿
侉	jkee·亻大一一ㄋㄋ
黻	jqe·业㡀一丿ㄋ丶
鹢	afiui·䒑八丨ㄋ丨丨
陔	yhre·阝亥丶一ㄋ丿
鏊	kvor·敖金丿丶一一
酤	tveiiu·酉古一丨丨ㄋ
貊	djoi·豸一丿丨ㄋ一
蚺	bsei·虫冂一丨一一
薤	fbie·艹歹丨一一一
荽	fyuo·艹爫ㄋ丿一一
胙	hzoeie·月乍丿一丨一
纻	xvee·纟宀一一一一
粝	qae·米厂一ㄋ丿丿
簋	lhiui·艮丨ㄋ丨丨
矇	bfeii·目艹一丨丨丨
畋	gnoeo·田攵丿一丿丶
甍	wqeuu·萝冖一ㄋㄋ丶
燋	pmrr·火隹丶丶丶丶
熳	pwiui·火日丨ㄋ丨丨
烝	cner·了一丶丶丶
楦	tveiu·木宀一丨ㄋ一
椟	tpur·木十ㄋ丶丶一
揎	gvei·扌宀一丨ㄋ一
庥	ajeio·广亻一丨丿丶
岍	yneeo·山开一一丿丨
媸	myeiu·女屮一丨ㄋ一
凇	wtor·冫木丿丶ㄋ丶
僳	jtr·亻覀丶丿一丨
侔	jcoee·亻厶丿一一丨
醑	tmi·酉疋丨ㄋ一一
邴	fduii·丙人ㄋ丨丨丨
遄	yyru·山而丶ㄋ丶丶
衒	fbuur·彳亠ㄋㄋ丶一
蜩	bseie·虫冂一丨一丨
葚	fguu·艹其ㄋㄋㄋㄋ
羼	zkr·尸羊丶丿一一
纩	xar·纟广丶一丿丿
秫	ctr·禾木丶丶丶丶
秕	cme·禾比一ㄋ丿ㄋ
瘌	lzii·疒束丨丨丨丨
潆	nwuu·氵ㄋㄋ丶丨
氘	vnoi·气丿丨丨丨
摅	gdru·扌虍丶ㄋ丶丶
佺	jdeei·亻人一一丨一
亶	bxiue·亠回丨ㄋ一一
鲊	dzoei·鱼乍丿一丨一
镪	vxiuee·钅弓丨ㄋ一一
鄯	kaiueu·羊䒑丨ㄋ一ㄋ
踔	zli·⺊丨ㄋ一一
赪	cliu·赤⺊丨ㄋ丿丶
觳	bjou·一丿ㄋ丿ㄋ
褙	hziue·衤北丨ㄋ一一
螽	nwiuei·夂⺀丨ㄋ一丨
蓥	wvo·金丿丶一一
肼	hyee·月井一一丿丨
聱	kyeiie·敖耳一丨丨一
耨	dyeir·耒辰一丨丶丶
绠	xbei·纟更一丨ㄋ一
绖	xge·纟至一ㄋ丶一
瞀	hniue·矛攵丨ㄋ一一
癜	lzei·疒尸一丨丨一
痱	lzie·疒非丨一一一
畤	gleir·田土一丨丶丶
猞	pqei·犭亼一丨丨ㄋ
溽	nyeir·氵辰一丨丶丶
溆	nqeio·氵亼一丨丿丶
毖	mloo·比心丿丿丿丿
栳	tfou·木耂丿ㄋㄋㄋ
捭	gdoiu·扌卑丿丨ㄋ一
悃	hkeio·忄囗一丨丿丶
彿	fxoii·彳弓丿丨丨丨
堙	lteie·土覀一丨一一
喈	kmoi·口比丿丨ㄋ一
俜	jaeuu·亻由一ㄋㄋㄋ
鹩	kwiue·大丷丨ㄋ一一
髑	mcou·骨罒丿ㄋ丨ㄋ
骟	atur·马户ㄋ丶一ㄋ
铗	vwor·钅𰀆丿丶丶丶
鋈	nfor·氵夭丿丶一一
醌	tweuo·酉日一ㄋ丿ㄋ
蚍	bmeu·虫比一ㄋ丿ㄋ
薅	fmeo·艹女一丿丿丿
萁	fgeii·艹其一丨丨一
芄	fgrr·艹九丶丶丶丶
胍	hyoour·月瓜丿丿ㄋ丶
绁	xduu·纟廿ㄋㄋㄋㄋ
笕	lfiuo·见丨ㄋ丿ㄋ
瞋	bhorr·目直丿丶丶丶
滹	ndoro·氵虍丿丶丿一
浬	ngiue·氵里丨ㄋ一一
泚	ntie·氵此丨一丨一
戽	tweiii·户⺀一丨丨丨
愔	hmrer·忄音丶一丶丿
嫠	dneou·未攵一丿ㄋ丿
卺	cnerr·了一丶丶丶
麹	xnour·夂丿ㄋ丶丿
鹣	yfou·兼鸟丿ㄋ丶ㄋ
鲅	ddur·鱼ㄋ丶丶丶
鞬	qsur·革聿ㄋ丶丶丶
躞	zpr·火丶一一一
躔	zaiu·广丨ㄋ一一
躐	zwi·巛丨ㄋ一ㄋ
豨	hheoiu·豕乂一丿丨ㄋ
诖	sheiee·讠圭一丨一一
蟥	bpiue·虫丨ㄋ一丨
蓂	wwr·日丶一丿丶
脘	hvee·月宀一一丿ㄋ
缵	xgoe·纟先丿一丨一
籼	qyiu·米山丨ㄋ丨丨
硭	dfr·石艹丶一ㄋㄋ
皲	qyuo·冖车ㄋ丿丨ㄋ
瘰	lguur·疒田ㄋㄋ丶丨
澌	ngoo·氵其丿丿一丨
漭	nfeo·氵艹一丿丶丶
洎	njoi·氵自丿丨ㄋ一
殍	byuie·歹爫ㄋ丨一一
槠	tseie·木讠一丨一丿
彖	ahou·彑丿ㄋ丿丿
堃	mmei·方方一丨一一
囝	ksuie·囗子ㄋ丨一一
嚭	akeoi·壴口一丿丨丶
刬	knii·戋刂丨丨丨丨
僦	jleo·亻京一丿ㄋ丶
鲮	dlo·鱼土丿丶丿ㄋ
阇	ffeieo·门者一丨一丿
郇	kmui·勹隹ㄋ丨丨丨
谝	stiu·讠户丨ㄋ一丨
詟	lsree·龙言丶一一一
襻	htoro·衤木丿丶丿丶
裒	btou·亠臼丿ㄋ丿丶
粜	ysroe·屮凵丶丿一丨
籥	lciuei·合丨ㄋ一丨
籀	lgou·扌丿ㄋ丶ㄋ
笮	lzoe·乍丿一丨一
熘	ppiuei·火丨ㄋ一丨
焐	pjiu·火五丨ㄋ一一
濞	njiuei·氵自丨ㄋ一丨
濉	nboi·氵目丿丨丶一
枧	tfiuo·木见丨ㄋ丿ㄋ
晡	wfeiu·日甫一丨ㄋ一
崦	ykiuee·山大丨ㄋ一一
埗	lhio·止丨丿丿丿
坌	sleiee·分土一丨一一
飐	ahie·几乂丨一丨ㄋ
靺	qde·革一一丨丿丶
谠	scou·讠丿ㄋㄋㄋ
袢	hjro·衤半丶丿一一
蝥	hniuei·矛攵丨ㄋ一丨
蝓	bqiuee·虫亼丨ㄋ一一
茑	ffour·艹鸟丿ㄋ丶ㄋ
茌	plei·𦫻士一丨一一
脶	hkiuo·月口丨ㄋ丿丶
笾	lwru·力丶ㄋ丶丶
瞢	wbiuee·萝目丨ㄋ一一
燹	hhroo·豕豕丶丿丿丶
殳	douu·殳丿ㄋㄋ丶丶
挢	gfoii·扌夭丿丨丨丨
扆	tjreo·户衣丶一丿ㄋ
慊	hyro·忄兼丶丿一ㄋ
悰	hveei·忄宀一一丨丿
埴	lheii·土直一丨丨ㄋ
嗞	kauur·口䒑ㄋㄋ丶ㄋ
冇	dsiuu·冂丨ㄋㄋㄋ
鹾	lko·⺊囗丿丶丶丿
鹁	bsou·子丿ㄋ丶ㄋ
隹	moi·隹丿丨丶一一
闿	fyue·门山ㄋ一ㄋㄋ
钍	vleie·钅土一丨一一
酎	tjei·酉寸一丨丶丶
跬	zhei·圭一丨一一
谳	spiur·讠十丨ㄋ丶丿
蝰	bkei·虫大一丨一一
蛞	bnoei·虫舌丿一丨丨
蚶	bdeii·虫甘一丨丨一
舣	pnro·舟义丶丿丶丶
缧	xguu·纟田ㄋㄋ丶丨
畀	giue·畀丨ㄋ一丨一
璩	sdeou·王虍一丿ㄋ丿
牤	cxre·牜亡丶一ㄋㄋ
潴	npeie·氵犭一丨一丿
梃	tsu·木壬ㄋ丶丶丶
朐	hkiuee·月勹丨ㄋ一一
旰	wneei·日干一一丨丨
擿	ghiuo·扌丨ㄋ丿丶
忮	hpurrr·忄十ㄋ丶丶丶
崁	ylou·山土丿ㄋ丿丶
尪	xsee·尢王一一丨一
宄	vgou·宀九丿ㄋㄋㄋ
埸	lwou·土日丿ㄋ丿丿
埏	ljie·土丿丨一丨一
儇	jceiu·亻罒一丨ㄋ一
髹	bjeio·髟亻一丨丿丶
饔	bpooi·亠丿丿丨丶
镢	varo·钅厂丶丿一ㄋ
钽	vqiu·钅旦丨ㄋ一一
酞	tkrrrr·酉大丶丶丶丶
郛	ysuii·爫孑ㄋ丨丨丨
赆	dkrrr·贝尺丶丶丶丶
豳	yheou·山豕一丿ㄋ丿
衄	jcui·丿皿ㄋ丨一一
舳	paiuei·舟由丨ㄋ一丨
舡	pleie·舟工一丨一一
肫	hbe·月屯一ㄋ丨ㄋ
羰	kyeoo·山一丿丿丿
罽	car·罒厂丶丿丿丶
祼	hweio·礻日一丨丿丶
矬	vfeiee·矢从一丨一一
癃	lyou·疒阝丿ㄋ丶丿
畛	gdoo·田人丿丿丿丿
畎	gpeo·田犬一丿丶丶
焓	pqi·火今丨ㄋ一一
泖	npou·氵卯丿ㄋ丿ㄋ
抃	gjeir·扌丶一丨丶丶
庹	dkueo·度尺ㄋ一丿丶
崟	yvor·山金丿丶一一
峁	ypou·山卯丿ㄋ丿ㄋ
囟	zhee·㐅一一一一
哏	khue·口艮ㄋ一一ㄋ
鲔	ddiue·鱼丨ㄋ一一
鲎	ndou·鱼丿ㄋ丨ㄋ
鲋	djeir·鱼亻一丨丶丶
鞳	qfo·革艹丿丶一丨
锶	vgr·钅田丶ㄋ丶丶
邽	hyuii·圭阝ㄋ丨丨丨
邠	syuii·分阝ㄋ丨丨丨
蒌	fquoe·艹米ㄋ丿一一
莸	fpeou·艹犭一丿ㄋㄋ
罨	ckiuee·罒大丨ㄋ一一
缊	xwiui·纟日丨ㄋ丨丨
糸	duu·糸ㄋㄋ丶丨丿
簏	lmre·鹿丶一丿ㄋ
笫	lxro·弟丶丿ㄋ一
涴	nvour·氵宀丿ㄋ丶ㄋ
浼	nwouu·氵丿ㄋㄋㄋ
浯	njiuee·氵五丨ㄋ一一
浠	nheoiu·氵乂一丿丨ㄋ
洇	nqiueo·氵因丨ㄋ一丿
泔	ndei·氵甘一丨丨一
桤	tyue·木山ㄋ一ㄋㄋ
曈	whiu·日立丨ㄋ一一
嵚	yvouo·山钅丿ㄋ丿丶
哕	kyour·口山丿ㄋ丶丶
亹	bseiu·亠冂一丨ㄋ一
亍	aee·亍一一丨丨丨
丌	jeo·丌一丿丨丨丨
鲥	dweir·鱼日一丨丶丶
驵	abiue·马且丨ㄋ一一
馓	ppiuee·饣丨ㄋ一一
鞴	qpo·革丿丿ㄋ一
鞮	qsi·革是丨ㄋ一一
锍	vxoiu·钅丿丨ㄋㄋ
逭	vhru·宀㠯丶ㄋ丶丶
袷	hcore·衤合丿丶一丨
蟮	bkro·虫羊丶丿一丨
舾	pteiu·舟西一丨ㄋ丿
耧	dquo·耒米ㄋ丿一一
缌	xgru·纟田丶ㄋ丶丶
绋	xxoi·纟弓丿丨丨丨
筚	lmeii·比一丨丨丨
窸	dmru·穴釆丶ㄋ丶丶
磙	dqur·石六ㄋ丶丿ㄋ
璺	tseiue·冂一丨ㄋ一
澶	nbiui·氵亠丨ㄋ丨ㄋ
溦	nyeou·氵山一丿ㄋ丿
洿	nkeeu·氵大一一ㄋㄋ
沢	nkueo·氵尺ㄋ一丿丶
氪	vvouuu·气古丿ㄋㄋㄋ
栝	tnoe·木舌丿一丨丨
枘	tliuor·木内丨ㄋ丿丶
旸	wtoo·日㇡丿丿丿丿
幞	yjr·巾业丶丿一一
岜	yguie·山巴ㄋ丨一ㄋ
咴	kdro·口丶丿丿丶
倮	jweio·亻日一丨丿丶
鸲	kkou·勹口丿ㄋ丶ㄋ
霅	psree·言丶一一一
锞	vwei·钅日一丨丿丶
铯	vdui·钅ㄋ丨一ㄋ
轹	ypio·车丨丿丶丶
贳	dpiuo·廿乚丨ㄋ丿丶
豇	hleiee·豆工一丨一一
蜣	bkou·虫羊丿ㄋㄋㄋ
蔟	fdoe·艹𭤨丿一一丿
蓠	fqiuu·艹㐫丨ㄋㄋ丶
艿	fwuoo·艹乃ㄋ丿丿丿
肟	hyuuu·月二ㄋㄋㄋㄋ
绨	xxr·纟弟丶丿ㄋ一
祲	hcru·礻彐丶ㄋㄋ丶
祎	hjeeu·礻韦一一ㄋ丨
瞭	bkroi·目大丶丿丨ㄋ
瘆	lcoo·疒丿丿丿丿
疳	adei·广甘一丨丨一
疔	laeii·疒丁一丨丨丨
瓿	hkeu·立口一ㄋㄋ丶
璘	sqou·王米丿ㄋ丶一
潾	nqour·氵米丿ㄋ丶一
泐	nyuoo·氵阝ㄋ丿丿丿
沚	nhie·氵止丨一丨一
欸	cvou·厶矢丿ㄋ丿丶
檑	tpiuei·木丨ㄋ一丨
樘	tce·木一丨一一
楯	taeiiu·木一丨丨ㄋ
椠	yqeio·车斤一丨丿丶
枵	tkeu·木口一ㄋㄋㄋ
擐	gcei·扌罒一丨ㄋ一
垚	lleie·土一丨一一
唣	kdeu·口白一ㄋㄋㄋ
卬	pwui·卩ㄋ丨丨丨
亸	gsr·子丶丿丨ㄋ
鳊	dtiue·鱼户丨ㄋ一丨
鍪	hnor·矛攵丿丶一一
醵	tdeou·酉虍一丿ㄋ丿
郾	vwuoe·匚日ㄋ丿一ㄋ
蹁	zti·户丨ㄋ一丨
觏	pseie·冂一丨一丨
襕	hfeiue·衤门一丨ㄋ一
袪	hweieu·衤去一丨一ㄋ
菉	fcire·艹丨丶一丿
芾	fjiui·艹一丨ㄋ丨丨
胂	hwii·月日丨丨丨丨
耜	dhiueu·耒㠯丨ㄋ一ㄋ
缳	xlou·纟丿ㄋ丿丶
篚	lvie·匚丨一一一
禋	hteie·礻覀一丨一一
硎	dneeo·石开一一丿丨
砉	xdeo·丰石一丿丨ㄋ
眊	bwoeeu·目毛丿一一ㄋ
瘳	lyor·疒羽丿丶丿丿
疬	lauo·疒厂ㄋ丿丿丿
枨	tboe·木长丿一ㄋ丶
曌	whrr·日月丶丶ㄋ丿
攮	gbiuei·扌丨ㄋ一丨
惛	hmi·忄氏丨ㄋ一一
尥	xkrr·尢勹丶丶丶丶
夐	dxiu·𠔿丨ㄋ一一
嗾	kdoe·口𭤨丿一一丿
唛	kxour·口丿ㄋ丶丶
匦	vyou·匚车丿ㄋㄋㄋ
刿	ybii·山夕丨丨丨丨
倕	jzoe·亻垂丿一丨一
俶	jlio·亻上丨丿丶ㄋ
黉	npiue·丨ㄋ一丨
鲡	dceiu·鱼丽一丨ㄋ丶
锝	vwee·钅日一一丨丶
酺	tfeiu·酉甫一丨ㄋ一
酃	phiue·吅丨ㄋ一ㄋ
赙	dfeir·贝甫一丨丶丶
谖	syeeo·讠爫一一丿ㄋ
蜱	bdoiu·虫卑丿丨ㄋ一
萆	fdoiue·艹卑丿丨ㄋ一
莩	fyuie·艹爫ㄋ丨一一
荸	fbui·艹ㄋ丨一一
苈	fauo·艹厂ㄋ丿丿丿
艨	pweeo·舟一一丿ㄋ
翚	yqeu·羽冖一ㄋ一丨
罾	cwro·罒曾丶丿丨ㄋ
砜	daorr·石几丿丶丶丶
皦	ddr·白白丶一ㄋ丿
瘐	ltor·疒臼丿丶丶丶
瓘	sfiu·王艹丨ㄋ一丨
珺	sciuee·王尹丨ㄋ一一
猓	pwei·犭日一丨丿丶
潲	nciro·氵禾丨丶丿丨
洫	njiui·氵丿丨ㄋ丨丨
沩	njuo·氵丶ㄋ丿丶丶
桫	tnio·木氵丨丿丶丿
朊	hyou·月二丿ㄋㄋㄋ
憷	hmuie·忄林ㄋ丨一丿
惝	hciui·忄丨ㄋ丨ㄋ
嶒	ywr·山曾丶丿丨ㄋ
埤	ldoiu·土卑丿丨ㄋ一
厣	apiuee·厂犬丨ㄋ一一
倬	jliue·亻⺊丨ㄋ一一
乂	hor·乂丿丶丶丶丶
龢	chiu·合吅丨ㄋ一丨
龁	hvuu·齿ㄋㄋㄋㄋ
鼯	tjiuee·鼠五丨ㄋ一一
黟	xbo·黑夕丿ㄋ丶丶
鹍	wmou·日比丿ㄋ丶ㄋ
鸰	qfou·令鸟丿ㄋ丶ㄋ
鲻	dwiuei·鱼巛丨ㄋ一丨
鲹	dcooo·鱼丿丿丿丿
骍	anre·马辛丶一丶丿
鞲	qpi·革丨ㄋ一丨
鞨	qwou·革日丿ㄋ丿丶
镦	vgui·钅ㄋ丨一丿
迕	vprur·十丶ㄋ丶丶
辀	ypoo·车舟丿丿ㄋ丶
蹐	znor·丿丶丨ㄋ
跱	zlei·土一丨丶丶
跏	ztuo·加ㄋ丿丨ㄋ
趵	zkrr·勹丶丶丶丶
诐	szuo·讠皮ㄋ丿丨ㄋ
蛴	bnoi·虫文丿丨丨丨
蕞	fweii·艹日一丨丨一
菪	fveo·艹宀一丿丨ㄋ
羝	kmrr·氏丶丶丶丶
綮	tnuu·户攵ㄋㄋ丶丨
磡	dguu·石其ㄋㄋ丿丿
硗	dpeu·石尧一ㄋ丿一
盦	qtiu·今酉丨ㄋ丨丨
皞	ddeo·白白一丿丶一
瘼	lyeii·疒莫一丨丨丨
瘵	lyee·疒一一丨丿
獍	pmo·犭音丿ㄋㄋㄋ
狳	pqeio·犭亼一丨丿丶
犰	pgou·犭九丿ㄋㄋㄋ
沄	nmee·氵云一一ㄋ丶
檩	tbiui·木亠丨ㄋ丨ㄋ
榱	tgeo·木一丿ㄋ丿
栌	tlue·木⺊ㄋ一丿丿
擗	gbue·扌辟ㄋ一丿丨
掎	gkeiue·扌大一丨ㄋ一
怃	hjeou·忄一一丿ㄋㄋ
忭	hjeirr·忄丶一丨丶丶
忉	hsuo·忄刀ㄋ丿丿丿
庋	apurr·广十ㄋ丶丶丶
壸	bseii·亚一丨丨丶
咍	kciue·口厶丨ㄋ一一
僇	jyor·亻羽丿丶丿丿
仉	jaou·亻几丿ㄋㄋㄋ
䜣	sqoo·讠斤丿丿一丨
龀	hnouu·齿匕丿ㄋㄋㄋ
鹆	fdiueo·八人丨ㄋ一丿
魋	smoi·鬼隹丿丨丶一
霪	pnor·氵丿丶丶丿
镘	vwiuii·钅日丨ㄋ丨丨
醣	taue·酉广ㄋ一一丨
酾	tcei·酉丽一丨ㄋ丶
鄠	pyuui·二ㄋㄋ丨丨
赑	ddiuor·贝贝丨ㄋ丿丶
谫	sauo·讠前ㄋ丿丿丿
谇	sbor·讠亠丿丶丿丶
襜	hhorre·衤厃丿丶丶一
蠓	bwee·虫一一丿ㄋ
蜞	bgei·虫其一丨丨一
虮	baouu·虫几丿ㄋㄋㄋ
蒽	fqr·艹因丶ㄋ丶丶
苁	ffor·艹从丿丶丿丶
芴	fjou·艹勿丿ㄋ丿丿
艟	phiuee·舟立丨ㄋ一一
笊	lyoo·爪丿丿丨丶
窊	dyoou·穴瓜丿丿ㄋ丶
窆	djrurr·穴丿丶ㄋ丶丶
碲	dhiui·石丨ㄋ丨丨
琇	scuooo·王禾ㄋ丿丿丿
狃	paui·犭丑ㄋ丨一一
瀹	nqiuei·氵亼丨ㄋ一丨
滉	nwir·氵日丨丶丿一
浐	nheoo·氵一丿丿丿
榘	vkeue·大一ㄋ一丨
掊	ghiuee·扌立丨ㄋ一一
恓	hteiuo·忄西一丨ㄋ丿
庳	adoi·广卑丿丨ㄋ一
帱	yxei·巾一丨丶丶
屺	ygueu·山已ㄋ一ㄋㄋ
夼	kwoi·大川丿丨丨丨
垤	lgeu·土至一ㄋ丶一
噍	kmrrr·口隹丶丶丶丶
嗉	kxuu·口ㄋㄋ丶丨
呙	kliuo·口内丨ㄋ丿丶
吽	kcoee·口牛丿一一丨
俣	jkeeo·亻口一一丿丶
仳	jmeu·亻比一ㄋ丿ㄋ
齁	jgou·自畀丿ㄋ丨ㄋ
鼗	xneie·儿一丨一丨
鹮	clou·罒丿ㄋ丿丶
馘	ajeu·䒑自一ㄋ丿丶
颃	baeo·亠几一丿丨ㄋ
顸	nneoiu·干页一丿丨ㄋ
阘	fwur·门日ㄋ丶一ㄋ
镵	vweu·钅一ㄋ丿ㄋ
镟	vduie·钅𭤨ㄋ丨一丿
镓	vveo·钅宀一丿ㄋ丿
酴	tqe·酉亼一丨丿丶
蹅	ztiu·木丨ㄋ一一
趼	zneeo·开一一丿丨
貘	dyeii·豸莫一丨丨丨
诼	shrrr·讠豕丶丶丶丶
蚵	baiu·虫丁丨ㄋ一一
蚰	baiue·虫由丨ㄋ一丨
薷	fpeoi·艹一丿丨ㄋ
蒗	yjue·落丶ㄋ一一ㄋ
苘	fsiuee·艹冂丨ㄋ一一
舯	pviu·舟中丨ㄋ一丨
缋	xliuor·纟丨ㄋ丿丶
绗	xfeei·纟彳一一丨丨
箅	lgiuei·畀丨ㄋ一丨
窬	dqiu·穴亼丨ㄋ一一
稃	cyuie·禾爫ㄋ丨一一
甓	bjeuu·辟瓦一ㄋㄋ丶
焜	pweuo·火日一ㄋ丿ㄋ
炻	pdeoi·火石一丿丨ㄋ
滏	nleei·氵父一一丨丶
涑	nzeiu·氵束一丨ㄋ一
浍	ndeeu·氵人一一ㄋ丶
氽	dniuo·人水丨ㄋ丿丶
氙	vyiui·气山丨ㄋ丨丨
楗	tsur·木聿ㄋ丶丶丶
梼	txe·木一丨丶丶
斝	hqrre·吅冖丶丶一丨
撙	gdei·扌酋一丨丶丶
摛	gqiuu·扌㐫丨ㄋㄋ丶
抔	gheoi·扌不一丿丨丶
崚	ylor·山土丿丶丿ㄋ
嗌	kaori·口䒑丿丶丨ㄋ
喾	njoe·告丿一丨一
唵	kkiuee·口大丨ㄋ一一
哜	knoi·口文丿丨丨丨
呒	kjeou·口一一丿ㄋㄋ
傒	jyuu·亻爫ㄋㄋ丶一
仫	jjur·亻丿ㄋ丶丶丶
龆	hsi·齿刀丨ㄋ一一
鹇	ftour·门木丿ㄋ丶ㄋ
鳣	dbiui·鱼亠丨ㄋ丨ㄋ
鳔	dtee·鱼覀一一丨丿
鲯	dgei·鱼其一丨丨一
鞒	qfoi·革夭丿丨丨丨
镮	vlou·钅丿ㄋ丿丶
镧	vfeiu·钅门一丨ㄋ一
镆	vyeiii·钅莫一丨丨丨
锸	vnoie·钅千丿丨一ㄋ
跶	zkru·大丶ㄋ丶丶
趑	mpre·走次丶一丿ㄋ
觫	hzeiue·角束一丨ㄋ一
蟛	baoo·虫壴丿丿丿丿
缡	xqiu·纟㐫丨ㄋㄋ丶
糍	qauu·米䒑ㄋㄋ丶ㄋ
簦	lyeiu·癶一丨ㄋ一
矻	dvu·石ㄋㄋㄋㄋ
瘥	lkeie·疒一丨一一
瘕	lque·疒叚ㄋ一丨一
烜	pjiue·火一丨ㄋ一一
渰	nceo·氵合一丿丨丨
檫	tvour·木宀丿ㄋ丶丶
晢	mwiue·折日丨ㄋ一一
敉	qnoe·米攵丿一丿丶
戥	wgeu·日生一ㄋ丿丶
忺	haouo·忄欠丿ㄋ丿丶
弇	cneoii·合廾一丿丨丨
尢	xeo·尢一丿ㄋㄋㄋ
姱	mkeeu·女大一一ㄋㄋ
厖	axoo·厂尢丿丿丿丶
冱	wjuu·冫一ㄋㄋ一一
龠	qhiu·亼吅丨ㄋ一丨
鲿	dcru·鱼丶ㄋ一一
饹	pzour·饣各丿ㄋ丶丨
飔	ahiue·几乂丨ㄋ一丨
颟	fforo·艹丙丿丶丿丶
铪	vcor·钅合丿丶一丨
钕	vmuo·钅女ㄋ丿一一
跫	lariu·工几丶丨ㄋ一
诹	syur·讠耳ㄋ丶丶丶
裛	bkui·亠口ㄋ丨一ㄋ
蠼	bbiue·虫目丨ㄋ一一
蜾	bweior·虫日一丨丿丶
蛲	bpeu·虫尧一ㄋ丿一
虓	gdou·九虍丿ㄋㄋㄋ
萑	fmoi·艹隹丿丨丶一
茇	fdurr·艹ㄋ丶丶丶
腠	hlee·月一一丿丶
糌	qnir·米夂丨丶丨ㄋ
箦	lxiu·丨ㄋ丿丶
筅	lgoe·先丿一丨一
砟	dzoeie·石乍丿一丨一
眭	bheiee·目圭一丨一一
甪	jtoue·丿用丿ㄋ一一
漶	nkiuei·氵口丨ㄋ一丨
洳	nmiue·氵女丨ㄋ一一
汆	dniuor·入水丨ㄋ丿丶
毐	lvuuo·士毋ㄋㄋ丿一
椓	thrrr·木豕丶丶丶丶
枲	ckeio·厶口一丨丿丶
昇	wjeoi·日丿一丿丨丨
揸	gtiue·扌木丨ㄋ一一
恧	ylr·而心丶ㄋ丶丶
嶝	yyei·山癶一丨ㄋ一
嵛	yqiue·山亼丨ㄋ一一
嵎	ywiuie·山日丨ㄋ丨一
屄	zdr·尸穴丶丶ㄋ丿
婞	mlro·女土丶丿一一
坜	lauoo·土厂ㄋ丿丿丿
剀	ygii·山己丨丨丨丨
佾	jfiu·亻八丨ㄋ一一
魆	skeu·鬼戉一ㄋㄋ丿
鄄	tlui·覀土ㄋ丨丨丨
逴	lweir·⺊日一丨丶ㄋ
逯	cnru·氺丶ㄋ丶丶
踦	zkeiu·大一丨ㄋ一
赇	dweire·贝求一丨丶一
谂	sqru·讠今丶ㄋ丶丶
裼	hwouoo·衤日丿ㄋ丿丿
裈	hqeue·衤冖一ㄋ一丨
蛏	bfeiee·虫又一丨一一
蒨	phee·𦫻青一一丨一
菔	fhui·艹月ㄋ丨丨丨
粢	pqr·次米丶丿一丨
硙	dyueu·石山ㄋ一ㄋㄋ
瘅	lhroi·疒单丶丿丨ㄋ
璠	smi·王釆丨ㄋ一丨
牾	cjiu·牜五丨ㄋ一一
烀	pboro·火乎丿丶丿一
炱	ckro·厶口丶丿丿丶
瀼	nbiuei·氵亠丨ㄋ一丨
潏	nhiuo·氵矛丨ㄋ丿丶
渟	ngeiii·氵一丨丨丨
氚	vwoii·气川丿丨丨丨
恝	xsru·丰刀丶ㄋ丶丶
孓	cjrr·了丶丶丶丶丶
嬲	gwuoe·田力ㄋ丿一ㄋ
圬	lyuu·土二ㄋㄋㄋㄋ
嚚	hqiuei·吅臣丨ㄋ一丨
劓	jgii·自畀丨丨丨丨
刭	pni·轻刂丨丨丨丨
冏	sfiue·冂八丨ㄋ一一
鹖	wkoruo·日勹丿丶ㄋ丿
鸺	jtour·亻木丿ㄋ丶ㄋ
鳀	dsiue·鱼是丨ㄋ一一
鲬	dtur·鱼甬ㄋ丶丨ㄋ
鲦	dnei·鱼夂一丨丿丶
骒	awei·马日一丨丿丶
隩	yzr·阝丶丿一丨
锔	vzui·钅尸ㄋ丨ㄋ一
铈	vbiui·钅亠丨ㄋ丨丨
钇	vpuu·钅乙ㄋㄋㄋㄋ
鋆	lkreo·土勹丶一丿丶
郤	fdiueu·八人丨ㄋ一ㄋ
蟪	bjiue·虫一丨ㄋ一一
葜	fxuo·艹丰ㄋ丿一丿
菝	fgeoo·艹扌一丿丿丿
舲	pqorru·舟令丿丶丶ㄋ
缲	xkiuei·纟口丨ㄋ一丨
笱	lkiuee·勹丨ㄋ一一
禘	hhiui·礻丨ㄋ丨丨
碶	dxu·石丰ㄋ丿一丿
矧	vxii·矢弓丨丨丨丨
眵	bbou·目夕丿ㄋ丶丶
畬	qtiue·亼朩丨ㄋ一丨
璁	szoure·王丿ㄋ丶一
牂	kkroee·爿羊丶丿一一
渖	nviue·氵宀丨ㄋ一一
洧	ndiuee·氵丨ㄋ一一
氡	vnrr·气夂丶丶丶丶
榖	bcou·禾丿ㄋㄋ丶
椀	tvouru·木宀丿ㄋ丶ㄋ
柈	tjro·木半丶丿一一
柃	tqor·木令丿丶丶ㄋ
昉	wmre·日方丶一ㄋ丿
揲	gdue·扌廿ㄋ一丨丿
拃	gzoei·扌乍丿一丨一
戋	keeu·戋一一ㄋ丿丶
廒	akee·广敖一一丨一
墁	lwiuii·土日丨ㄋ丨丨
堋	lhou·土月丿ㄋ一一
伲	jzou·亻尸丿ㄋㄋㄋ
鲼	dpei·鱼十一丨丨丨
骺	maei·骨一丨ㄋ一
驲	awi·马日丨ㄋ一一
饸	pcore·饣合丿丶一丨
陴	ydoiue·阝卑丿丨ㄋ一
锼	vtii·钅臼丨丨丨丨
锳	vfiueo·钅艹丨ㄋ一丿
锩	vlu·钅ㄋㄋㄋㄋ
铫	vxre·钅儿丶一丿丶
钐	vwoo·钅彡丿丿丿丿
酂	ggiuo·先先丨ㄋ丿丶
郿	zbu·目ㄋ丨丨丨
郐	dmui·人云ㄋ丨丨丨
跽	zgr·己丶ㄋ丶丶
诇	ssiu·讠冂丨ㄋ一一
觱	klou·戊丿ㄋ丿ㄋ
觋	lfiuou·工从丨ㄋ丿ㄋ
蠛	bweo·虫萝一丿ㄋ丿
蝤	bdr·虫酋丶丿一丨
虼	bvuu·虫ㄋㄋㄋㄋ
蔸	fdoiue·艹白丿丨ㄋ一
茈	ftiei·艹此丨一丨一
艋	psiui·舟子丨ㄋ丨丨
臑	hpeoiu·月一丿丨ㄋ
胗	hdoo·月人丿丿丿丿
耑	yyeo·山而一丿丨ㄋ
翾	clouo·罒丿ㄋ丿丶
缞	xgeo·纟一丿ㄋ丿
绹	xkoe·纟勹丿一一丨
縢	hluu·月ㄋㄋ丶丨
糈	qmiu·米疋丨ㄋ一一
笸	lviue·匚丨ㄋ一一
礅	dguie·石ㄋ丨一丿
癀	lpiuei·疒丨ㄋ一丨
痖	lseii·疒亚一丨丨丶
玦	svor·王丿丶丶丶
熛	ptee·火覀一一丨丿
煳	pvoue·火古丿ㄋ一一
滃	ncur·氵公ㄋ丶一ㄋ
汔	nvuu·氵ㄋㄋㄋㄋ
氿	ngou·氵九丿ㄋㄋㄋ
毹	qhiio·亼⺝丨丨丿一
殪	bbei·歹一丨ㄋ一
檎	tdreo·木人丶一丿丶
槚	ttiu·木覀丨ㄋ丿丶
桕	ttoi·木臼丿丨一ㄋ
枒	taeui·木牙一ㄋ丨丿
揠	gviue·扌匚丨ㄋ一一
帨	ykou·巾𠮦丿ㄋㄋㄋ
巉	yweuo·山一ㄋ丿ㄋ
嵝	yquo·山米ㄋ丿一一
崿	yhee·山吅一一ㄋㄋ
岽	yyio·山丨丿丶丶
岨	ybiuee·山且丨ㄋ一一
尨	xwrr·尢彡丶丶丶丶
嫪	myor·女羽丿丶丿丿
塄	lcre·土罒丶一ㄋ丿
坰	lsiue·冂丨ㄋ一一
坫	ltiei·土占丨一丨ㄋ
啫	kfeieo·口者一丨一丿
唼	khuo·口立ㄋ丿一一
勍	lwuoo·京力ㄋ丿丿丿
劄	lciii·合丨丨丨丨
麑	mto·鹿臼丿ㄋㄋㄋ
鹡	ndiuee·人丨ㄋ一一
鸧	dgou·人丿ㄋ丶ㄋ
鲰	dyurr·鱼耳ㄋ丶丶丶
鲐	dciuee·鱼厶丨ㄋ一一
髟	bei·髟一丨一一一
靸	qso·革及丿ㄋ丶丶
钖	vto·钅㇡丿丿丿丿
钌	vcui·钅了ㄋ丨丨丨
醾	tyr·酉麻丶丿一丨
轵	ykorr·车口丿丶丶丶
躜	zgoei·先丿一丨一
跞	zpio·丨丿丶丶
谞	smiu·讠疋丨ㄋ一一
訚	fsr·门言丶一一一
衎	fneeii·彳干一一丨丨
螗	baue·虫广ㄋ一一丨
蛸	bciuee·虫丨ㄋ一一
蒻	fxre·艹弓丶一丶一
芑	fgue·艹己ㄋ一ㄋㄋ
舴	pzoei·舟乍丿一丨一
脬	hyuie·月爫ㄋ丨一一
耪	dhreu·耒丶一ㄋ丿
簃	lcour·禾丿ㄋ丶丿
筦	lveeou·宀一一丿ㄋ
硪	dwoei·石我丿一丨一
硁	dpure·石轻ㄋ丶一丨
皛	ddoiu·白白丿丨ㄋ一
瑨	ssiue·王亚丨ㄋ一一
爇	flor·艹土丿丶一丨
熇	pgiuee·火丨ㄋ一一
渫	ndue·氵廿ㄋ一丨丿
淠	ngiuei·氵畀丨ㄋ一丨
浡	npru·氵十丶ㄋㄋ丨
氾	nguuu·氵ㄋㄋㄋㄋ
氍	bboire·目目丿丨丶一
欻	ppo·火火丿ㄋ丿丶
楙	theior·木矛一丨丿丶
棐	zte·非木一丨丿丶
杻	taui·木丑ㄋ丨一一
搿	ncoe·合丿一一丨
挦	gceir·扌彐一丨丶丶
惙	hfur·忄双ㄋ丶ㄋ丶
悝	hgiu·忄里丨ㄋ一一
廋	atiu·广臼丨ㄋ丶丶
巇	ydeiu·山虍一丨ㄋ一
嵫	yauur·山䒑ㄋㄋ丶ㄋ
崒	yboro·山亠丿丶丿丶
峣	ypeu·山尧一ㄋ丿一
岢	ygeiue·山可一丨ㄋ一
嬅	mfeei·女艹一一丨丨
媞	msiuee·女是丨ㄋ一一
夬	vdor·人丿丶丶丶
埘	lweirr·土日一丨丶丶
埆	lhouo·角丿ㄋ丿ㄋ
垧	lziu·土丨ㄋ一一
哢	kseo·口王一丿丨丨
僬	jmrr·亻隹丶丶丶丶
俵	jxouo·亻丿ㄋ丿丶
黹	jqro·业㡀丶丿丨ㄋ
鳇	ddeei·鱼白一一丨一
鬘	bwiui·髟日丨ㄋ丨丨
髎	myoro·骨羽丿丶丿丿
馌	pwiuii·饣去丨ㄋ丨丨
飑	ahouu·几乂丿ㄋㄋ一
颎	npeoiu·匕火一丿丨ㄋ
阌	fyur·门ㄋ丶丶丶
镡	vtiue·钅覀丨ㄋ一一
镙	vguu·钅田ㄋㄋ丶丨
铼	vwio·钅𰀆丨丿丶丶
钬	vproo·钅火丶丿丿丶
醭	tjroe·酉业丶丿一一
醨	tqiuu·酉㐫丨ㄋㄋ丶
鄜	myuii·鹿阝ㄋ丨丨丨
迮	zrr·乍辶丶ㄋ丶丶
螬	bjiuei·虫一丨ㄋ一丨
蜎	bkiuee·虫口丨ㄋ一一
蔀	fhiue·艹立丨ㄋ一ㄋ
蒉	fliuo·艹丨ㄋ丿丶
萩	fcro·艹禾丶丿丿丶
荭	fxei·艹纟一丨一一
荄	fhreuo·艹亥丶一ㄋ丿
臁	har·月广丶丿一ㄋ
脒	hqro·月米丶丿一丨
胨	hyio·月丨丿丶丶
肜	hwoo·月彡丿丿丿丿
翃	dcu·厶ㄋ丶一ㄋ
绲	xwe·纟日一ㄋ丿ㄋ
糵	fjiueu·艹丿丨ㄋ一ㄋ
簕	lquoo·革ㄋ丿丿丿
穸	dbour·穴夕丿ㄋ丶丶
穟	cweo·禾丷一丿ㄋ丿
稂	cju·禾丶ㄋ一一ㄋ
瞍	btiu·目臼丨ㄋ丶丶
癍	lsreo·疒王丶一丿丶
畯	gcor·田厶丿丶丿ㄋ
甏	aweu·壴彡一ㄋㄋ丶
珧	sxr·王儿丶一丿丶
濩	nfoir·氵艹丿丨丶一
溱	nloe·氵丿一丨丿
淏	nweeor·氵日一一丿丶
洸	nhir·氵光丨丶丿一
洑	njeor·氵亻一丿丶丶
沨	naorr·氵几丿丶丶丶
橦	thiuee·木立丨ㄋ一一
槔	tdeor·木白一丿丶一
棨	tneio·户攵一丨丿丶
棓	thiuee·木立丨ㄋ一一
杙	tkeur·木弋一ㄋ丶丶
昺	wfor·日丙丿丶丶丶
搒	ghre·扌丶一ㄋ丿
掞	gpro·扌火丶丿丿丶
捃	gciue·扌尹丨ㄋ一一
憝	gsoeo·孑丿一丿丶
庀	anou·广匕丿ㄋㄋㄋ
岣	ykiuee·山勹丨ㄋ一一
屼	yjou·山一丿ㄋㄋㄋ
垲	lyue·土山ㄋ一ㄋㄋ
黪	xcoo·黑丿丿丿丿
鹋	fgou·艹田丿ㄋ丶ㄋ
鸸	yfour·而鸟丿ㄋ丶ㄋ
鳓	dquoo·鱼革ㄋ丿丿丿
鳑	dhreuo·鱼丶一ㄋ丿
鲣	dmei·鱼一丨一一
鲗	ddii·鱼贝丨丨丨丨
鲏	dzuo·鱼皮ㄋ丿丨ㄋ
髽	bfeiee·髟从一丨一一
飗	ahour·几乂丿ㄋ丶ㄋ
靿	qpu·革幺ㄋ丿丿丿
雱	pmre·方丶一ㄋ丿
阽	ytie·阝占丨一丨ㄋ
镋	vcouu·钅丿ㄋㄋㄋ
锽	vdeei·钅白一一丨一
锇	vwoe·钅我丿一丨一
铏	vnee·钅开一一丿丨
跐	ztie·此丨一丨一
赟	njeur·文一一ㄋ丶丨
謦	lzouur·士丿ㄋㄋ丶
襚	hweo·衤丷一丿ㄋ丿
蛑	bcoe·虫厶丿一一丨
藟	fgiue·艹田丨ㄋ一丨
蔹	fqrr·艹亼丶丶丿一
蒐	fsoi·艹鬼丿丨ㄋ一
莰	flouo·艹土丿ㄋ丿丶
莛	fsur·艹壬ㄋ丶丶丶
荬	ftrr·艹乛丶丶一丿
芈	jjie·丨一丨一一一
芃	farr·艹几丶丶丶丶
艚	pjiuei·舟一丨ㄋ一丨
腯	haeii·月一丨丨ㄋ
腧	hqiuee·月亼丨ㄋ一一
脞	hfeiee·月从一丨一一
肭	hliuor·月内丨ㄋ丿丶
翀	yviu·羽中丨ㄋ一丨
缍	xzo·纟垂丿一丨一
缂	xqe·纟革一丨丨一
粿	qwei·米日一丨丿丶
簠	lfiui·甫丨ㄋ丨丨
篥	lteio·覀一丨丿丶
秬	cvu·禾匚ㄋ一一一
碥	dtiuei·石户丨ㄋ一丨
睎	bheo·目乂一丿丨ㄋ
眢	bgiu·夕丨ㄋ一一
瑳	skeie·王一丨一一
瑑	saouo·王彑丿ㄋ丿丿
狁	pcou·犭厶丿ㄋㄋㄋ
烺	pjuee·火丶ㄋ一一ㄋ
澥	nhuo·氵角ㄋ丿丿一
潟	ntour·氵臼丿ㄋ丶丶
滪	nheoiu·氵予一丿丨ㄋ
滆	nlei·氵鬲一丨ㄋ一
溞	nfri·氵又丶丨ㄋ一
浈	nliuo·氵⺊丨ㄋ丿丶
泶	nniuo·水丨ㄋ丿丶
枹	tkue·木勹ㄋ一ㄋㄋ
暵	wdi·日廿丨ㄋ一丿
弢	xyurr·弓山ㄋ丶丶丶
尜	ckio·小大丨丿丶丶
嫜	mmeii·女音一丨丨丨
奓	kbour·大夕丿ㄋ丶丶
墐	lyeiie·堇一丨丨一
剟	ffii·双双丨丨丨丨
剞	kgiii·大可丨丨丨丨
佧	jlirr·亻上丨丶丶丶
伈	jlrur·亻心丶ㄋ丶丶
龂	hqui·齿斤ㄋ丨丿丿
鼷	tyuu·鼠爫ㄋㄋ丶一
鹴	pvour·相丿ㄋ丶ㄋ
鹨	ydoooo·羽人丿丿丿丿
鹔	snor·肀丿丨丿ㄋ
鞡	qgre·革扌丶一丶丿
鞔	qwouu·革丿ㄋㄋㄋ
闶	fbou·门亠丿ㄋㄋㄋ
镴	vwiueu·钅巛丨ㄋ一ㄋ
镈	vfeir·钅甫一丨丶丶
锾	vyee·钅爫一一丿ㄋ
锛	vkeieo·钅大一丨一丿
铷	vmi·钅女丨ㄋ一一
辌	ylre·车京丶一丨ㄋ
踶	zsiu·是丨ㄋ一一
赗	dwiuee·贝日丨ㄋ一一
赒	dseiei·贝冂一丨一丨
谿	ypeor·爫幺一丿丶丿
褕	hqiuee·衤亼丨ㄋ一一
袆	hjeeui·衤韦一一ㄋ丨
蠋	bcoui·虫罒丿ㄋ丨ㄋ
螣	hliue·月丨ㄋ一丨
蝻	bpiur·虫十丨ㄋ丶丿
蕰	ywiuii·落日丨ㄋ丨丨
蒱	fgeiu·艹扌一丨ㄋ一
蒎	yaouo·落丿ㄋ丿丶
茚	fpeui·艹一ㄋ丨丨
舠	psuo·舟刀ㄋ丿丿丿
肸	hfeii·月八一丨丨丨
聍	yvei·耳宀一丨丨丨
耵	yaeii·耳丁一丨丨丨
糇	qjue·米亻ㄋ一丿一
粞	qtei·米西一丨ㄋ丿
礌	dpiue·石丨ㄋ一丨
碹	dvei·石宀一丨ㄋ一
硇	dzore·石丿丶一一
砩	dxoii·石弓丿丨丨丨
瘃	lhrr·疒豕丶丶丶丶
疢	lpro·疒火丶丿丿丶
瓞	yjeeor·瓜丿一一丿丶
璆	syoro·王羽丿丶丿丿
瑢	sdor·王穴丿丶丨ㄋ
琯	sviu·王宀丨ㄋ一ㄋ
琭	scir·王丨丶一丿
琤	sbouu·王争丿ㄋㄋ一
獯	pniu·犭千丨ㄋ丶丿
猰	pxuo·犭丰ㄋ丿一丿
狝	paoui·犭尔丿ㄋ丨丿
爝	pyiuii·火爫丨ㄋ丨丨
爚	pciuei·火合丨ㄋ一丨
烔	pseiu·火冂一丨ㄋ一
橑	tkro·木大丶丿丨ㄋ
椐	tzei·木尸一丨丨ㄋ
朳	tforr·木八丿丶丶丶
憺	hhorre·忄厃丿丶丶一
惔	hpro·忄火丶丿丿丶
怊	hsiu·忄刀丨ㄋ一一
忳	hbeu·忄屯一ㄋ丨ㄋ
彳	foo·彳丿丿丨丨丨
廑	ayeii·广堇一丨丨一
岵	yveii·山古一丨丨ㄋ
孅	mfeu·女从一ㄋ丿丶
嫽	mkro·女大丶丿丨ㄋ
墼	ysouu·車凵丿ㄋㄋ丶
圊	kheei·囗青一一丨一
嗍	ksou·口屰丿ㄋ一一
叆	myeou·云一丿ㄋ丶
儳	jweu·亻一ㄋ丿ㄋ
偲	jgr·亻田丶ㄋ丶丶
乇	jneuu·丿七一ㄋㄋㄋ
黡	apiur·厂犬丨ㄋ丶丿
鳂	dgeuor·鱼田一ㄋ丿丶
鲞	ldoui·鱼丿ㄋ丨ㄋ
鲕	dyeoi·鱼而一丿丨ㄋ
鬏	bcroo·髟禾丶丿丿丶
骱	mdoii·骨人丿丨丨丨
颥	pyeo·而一丿丨ㄋ
韨	jdur·韦ㄋ丶丶丶
雊	kkoi·勹口丿丨丶一
隃	yqiuee·阝亼丨ㄋ一一
镠	vyor·钅羽丿丶丿丿
锓	vcru·钅彐丶ㄋㄋ丶
铟	vqiue·钅因丨ㄋ一丿
铘	vaui·钅牙ㄋ丨丨丨
铒	vyeiie·钅耳一丨丨一
酏	tdui·酉也ㄋ丨ㄋㄋ
辁	ydeei·车人一一丨一
蹯	zmi·釆丨ㄋ一丨
讻	shui·讠乂ㄋ丨丨丨
觿	hyoir·角山丿丨丶一
觖	hvorr·角丿丶丶丶
袼	hzouri·衤各丿ㄋ丶丨
螋	btiur·虫臼丨ㄋ丶丶
蕺	fkeiie·艹口一丨丨一
蓢	fjueeu·艹丶ㄋ一一ㄋ
莶	fqrro·艹亼丶丶丿一
茺	fxou·艹丿ㄋㄋㄋ
茝	fqeii·艹一丨丨ㄋ
苤	fheee·艹不一一一一
芤	fsuu·艹孑ㄋㄋㄋㄋ
芏	fleiee·艹土一丨一一
艎	pdeei·舟白一一丨一
腘	hkeeie·月囗一一丨一
胲	hhreu·月亥丶一ㄋ丿
胬	clor·奴内丿丶丶丶
胠	hweieu·月去一丨一ㄋ
肷	haouor·月欠丿ㄋ丿丶
耰	ddiuee·耒丆丨ㄋ一一
耇	fkiuee·耂勹丨ㄋ一一
羕	kjuuo·丶ㄋㄋ丿丶
绱	xciui·纟丨ㄋ丨ㄋ
纴	xsoei·纟壬丿一丨一
糒	qpoo·米丿丿ㄋ一
簰	lkoi·片丿丨ㄋ一
簉	ljru·告丶ㄋ丶丶
篼	ldouo·白丿ㄋ丿ㄋ
筥	lkiuee·口丨ㄋ一一
稆	ckiuee·禾口丨ㄋ一一
祃	hauue·礻马ㄋㄋ一一
碡	dxuu·石ㄋㄋ丶一
矰	vwr·矢曾丶丿丨ㄋ
瘛	lxu·疒丰ㄋ丿丶ㄋ
疐	bgui·田ㄋ丨一丿
甦	bgoe·更生丿一一丨
玃	pbiuee·犭目丨ㄋ一一
瀵	nqiuei·氵米丨ㄋ一丨
澴	nceiu·氵罒一丨ㄋ一
滠	nyur·氵耳ㄋ丶ㄋ丶
湉	nhoe·氵忄丿一丨丨
涘	ncoee·氵厶丿一一丿
殣	byeiie·歹堇一丨丨一
椑	tdoi·木卑丿丨ㄋ一
棬	tluu·木ㄋㄋㄋㄋ
杩	tauue·木马ㄋㄋ一一
昽	wleou·日龙一丿ㄋ丿
敫	dmoe·白方丿一丿丶
慆	hyoie·忄爫丿丨一ㄋ
彟	cjei·彐寸一丨丨ㄋ
崾	ytuo·山覀ㄋ丿一一
岠	yvue·山匚ㄋ一一一
嫘	mguu·女田ㄋㄋ丶丨
墦	lmi·釆丨ㄋ一丨
埼	lkeiu·大一丨ㄋ一
埵	lzoei·垂丿一丨一
坬	lyoou·瓜丿丿ㄋ丶
噀	kgue·口巳ㄋ一ㄋ一
嘚	kfiue·口彳丨ㄋ一一
唪	kleei·口一一丨丨
叇	mcir·云丨丶一丿
卣	lkuee·⺊囗ㄋ一一一
劂	asou·厂屰丿ㄋ丿丶
冁	hzeii·单尸一丨丨一
伋	jsour·亻及丿ㄋ丶丶
仂	jwuo·亻力ㄋ丿丿丿
鹯	bxiuee·亠回丨ㄋ一一
鹙	cpo·禾火丿ㄋ丶ㄋ
鳙	daue·鱼广ㄋ一一丨
鲴	dkeiiu·鱼囗一丨丨ㄋ
鲌	ddoiue·鱼白丿丨ㄋ一
馉	pmiuu·饣骨丨ㄋㄋ丶
馃	pweio·饣日一丨丿丶
饳	pyui·饣屮ㄋ丨丨丨
陧	yweie·阝日一丨一一
陞	yjeoi·阝丿一丿丨一
铚	vge·钅至一ㄋ丶一
钭	vweii·钅⺀一丨丨丨
鄹	yfoio·耳又丿丨丿丿
郈	alu·ㄋ丨丨丨
邶	zyui·北阝ㄋ丨丨丨
遹	hsoriu·矛冂丿丶丨ㄋ
辒	ywiuii·车日丨ㄋ丨丨
蹜	zvor·宀丿丶一丿
趯	myoi·走羽丿丨丶一
赕	dpro·贝火丶丿丿丶
裉	hhuee·衤艮ㄋ一一ㄋ
衠	fhore·彳直丿丶一一
蟫	btiue·虫覀丨ㄋ一一
蛘	bkroe·虫羊丶丿一一
蔊	fpiu·艹火丨ㄋ一一
蓰	ffie·艹彳丨一丨一
葎	ffu·艹彳ㄋ一一一
茼	fseiu·艹冂一丨ㄋ一
茳	yleiee·落工一丨一一
舭	pmeu·舟比一ㄋ丿ㄋ
臜	hgoe·月先丿一丨一
缏	xjeiu·纟亻一丨ㄋ一
绤	xfor·纟八丿丶丨ㄋ
簖	lquooe·米ㄋ丿丿一
筻	lbeiu·更一丨ㄋ一
窀	dbeuiu·穴屯一ㄋ丨ㄋ
璈	skeei·王敖一一丨一
珌	sloo·王心丿丿丿丿
燏	phiuor·火矛丨ㄋ丿丶
焞	pgui·火ㄋ丨一一
澛	ndiuee·氵鱼丨ㄋ一一
澉	nteii·氵乛一丨丨一
滫	njoeo·氵丿一丿丶
淜	nhou·氵月丿ㄋ一一
涠	nkeeui·氵囗一一ㄋ丨
洺	nbiuee·氵夕丨ㄋ一一
沲	nvui·氵ㄋ丨ㄋㄋ
棁	tkou·木𠮦丿ㄋㄋㄋ
柷	tkouu·木口丿ㄋㄋㄋ
朏	hyuiii·月屮ㄋ丨丨丨
晫	wliu·日⺊丨ㄋ一一
昒	wjou·日勿丿ㄋ丿丿
旐	dxre·𭤨儿丶一丿丶
斠	pseier·冂一丨一丶
敔	jkoe·五口丿一丿丶
攉	gpoi·扌丿丨丶一
捯	ggii·扌至丨丨丨丨
慭	wneor·𰀆𡭔一丿丶丶
惎	glru·其心丶ㄋ丶丶
悢	hjue·忄丶ㄋ一一ㄋ
廾	neoi·廾一丿丨丨丨
帡	yaeo·巾䒑一丿丨丨
嬿	mdiu·女廿丨ㄋ一丶
塅	lgoi·段丿丨一一
垞	lvoeu·宀丿一ㄋㄋ
坶	lvuur·土母ㄋㄋ丶一
喤	kdeei·口白一一丨一
哳	kmeie·口折一丨一丿
吣	klrurr·口心丶ㄋ丶丶
僰	qqor·朿朿丿丶丶丶
偭	jheo·亻面一丿丨ㄋ
偓	jzeu·亻尸一ㄋ丶一
佽	jpre·亻次丶一丿ㄋ
鼽	jgouu·自畀丿ㄋㄋㄋ
鼢	tsoru·鼠分丿丶ㄋ丿
鹎	dfouru·卑鸟丿ㄋ丶ㄋ
鳠	dfoir·鱼艹丿丨丶一
鳘	vvoeor·母丿一丿丶
鲩	dveeo·鱼宀一一丿ㄋ
鲚	dnoii·鱼文丿丨丨丨
鲒	dneie·鱼吉一丨一丨
鲃	dguieu·鱼巴ㄋ丨一ㄋ
鬒	bhorrr·髟直丿丶丶丶
鞁	qz·革皮ㄋ丿丨ㄋ
镃	vauu·钅䒑ㄋㄋ丶ㄋ
锧	vaeio·钅一丨丿丶
锊	vyeir·钅爫一丨丶丶
铞	vkiui·钅口丨ㄋ丨丨
钪	vbou·钅亠丿ㄋㄋㄋ
钆	vpuuu·钅乚ㄋㄋㄋㄋ
銎	laro·工几丶丿丶一
鄫	wyu·曾阝ㄋ丨丨丨
邲	ljui·心丿ㄋ丨丨丨
迺	trru·西辶丶ㄋ丶丶
蹢	zhiuei·丨ㄋ一丨
踺	zsur·聿ㄋ丶丶丶
讱	ssrrr·讠刀丶丶丶丶
蝘	bviue·虫匚丨ㄋ一一
虒	adou·虍丿ㄋㄋㄋ
薢	nhuoo·氵角ㄋ丿丿一
蕻	fbei·艹镸一丨丨一
蒟	fhoui·艹立丿ㄋ丨ㄋ
菂	fdour·艹白丿ㄋ丶丶
芼	fwoee·艹毛丿一一ㄋ
膣	hdeu·月穴一ㄋ丶一
腽	hwiui·月日丨ㄋ丨丨
脿	hxouo·月丿ㄋ丿丶
耔	dsui·耒子ㄋ丨一一
翙	ybu·山夕ㄋ丶一ㄋ
羖	kdouu·殳丿ㄋㄋ丶
罱	cpi·罒十丨ㄋ丶丿
繄	vvouur·匚矢丿ㄋㄋ丶
窎	dfouru·穴鸟丿ㄋ丶ㄋ
稌	cqe·禾亼一丨丿丶
禔	hwiue·礻日丨ㄋ一一
祕	hlo·礻心丿丿丿丿
祏	hdeo·礻石一丿丨ㄋ
磉	dfur·石又ㄋ丶ㄋ丶
砹	dfor·石艹丿丶丶丶
砘	dbeuiu·石屯一ㄋ丨ㄋ
砗	dyeu·石车一ㄋ一丨
眍	bmeo·目区一丿丶ㄋ
皭	dyiuii·白爫丨ㄋ丨丨
痦	ljiuee·疒五丨ㄋ一一
疍	mqiue·疋旦丨ㄋ一一
璪	skiuei·王口丨ㄋ一丨
琲	szie·王非丨一一一
琫	slee·王一一丨丨
玡	saeu·王牙一ㄋ丨丿
玚	stoo·王㇡丿丿丿丿
玘	sgue·王己ㄋ一ㄋㄋ
犨	mmo·隹隹丿一一丨
牿	cjo·牜告丿一丨一
煴	pwiuii·火日丨ㄋ丨丨
焗	pzu·火尸ㄋ丨ㄋ一
瀍	naiue·氵广丨ㄋ一一
滗	nloee·氵丿一一ㄋ
湑	nmiuee·氵疋丨ㄋ一一
浉	nneiu·氵一丨ㄋ丨
洚	nneu·氵夂一ㄋ丨丨
汋	nkrrr·氵勹丶丶丶丶
槱	ttr·木酉丶丶丶丶
榍	tziro·木尸丨丶丿丨
棫	tkiuee·木戈丨ㄋ一一
梿	tyru·木车丶ㄋ丶丶
柊	tnrr·木夂丶丶丶丶
晙	wcor·日厶丿丶丿ㄋ
昈	wtr·日户丶ㄋ一丿
搛	gyr·扌兼丶丿一ㄋ
掭	gfir·扌天丨丶丶丶
扊	tproo·户火丶丿丿丶
忞	nlrur·文心丶ㄋ丶丶
庼	aneo·广一丿丨ㄋ
岞	yzoei·山乍丿一丨一
屃	zdiu·尸贝丨ㄋ丿丶
孖	ssui·子子ㄋ丨一一
嫕	mvoee·女匚丿一一丿
嫄	maoi·女厂丿丨ㄋ一
媭	wnu·彡页ㄋ丿一一
婘	mlu·女ㄋㄋㄋㄋ
娵	myur·女耳ㄋ丶丶丶
娀	mkeo·女戈一丿丿丿
姤	maeiu·女一丨ㄋ一
姞	mnei·女吉一丨一丨
奭	kjoiu·大一丿丨ㄋ一
奡	dbeo·丆目一丿丶丿
堨	lwouo·日丿ㄋ丿丶
堍	lwour·土丿ㄋ丶丶
咇	kloo·口心丿丿丿丿
勚	dpiuor·廿乚丨ㄋ丿丶
劢	wwuoo·万力ㄋ丿丿丿
冮	wleie·冫工一丨一一
傢	jveo·亻宀一丿ㄋ丿
偰	jxu·亻丰ㄋ丿一丿
倞	jlre·亻京丶一丨ㄋ
倓	jproo·亻火丶丿丿丶
麀	mnou·鹿匕丿ㄋㄋㄋ
鹛	zbo·目丿ㄋ丶ㄋ
鹒	acoro·广彐丿丶丿ㄋ
鹀	lfou·工从丿ㄋ丶ㄋ
鸻	faour·彳亍丿ㄋ丶ㄋ
鸤	zfou·尸鸟丿ㄋ丶ㄋ
鳒	dyro·鱼兼丶丿一ㄋ
鳈	ddiuor·鱼白丨ㄋ丿丶
鲾	dli·鱼丨ㄋ一丨
鲖	dseiue·鱼冂一丨ㄋ一
鬷	lhui·鬲㐅ㄋ丨ㄋ丶
髢	bduiu·髟也ㄋ丨ㄋㄋ
骕	asoi·马肀丿丨丿丶
骉	aau·马马ㄋㄋ一一
骃	aqi·马因丨ㄋ一丿
靰	qjouu·革一丿ㄋㄋㄋ
镲	vvour·钅宀丿ㄋ丶丶
镱	vmru·钅音丶ㄋ丶丶
镩	vvorr·钅宀丿丶丶丶
镨	vaii·钅䒑丨丨丶丿
镚	vyoue·钅山丿ㄋ一一
镅	vziu·钅丨ㄋ一一
锬	vproor·钅火丶丿丿丶
锪	vjru·钅勿丶ㄋ丶丶
锎	vfeeo·钅门一一丿丨
铑	vfouu·钅耂丿ㄋㄋㄋ
钫	vmre·钅方丶一ㄋ丿
钔	vfri·钅门丶丨ㄋㄋ
鐾	bvor·辟金丿丶一一
酦	txuou·酉发ㄋ丿ㄋ丶
鄗	gkuii·口ㄋ丨丨丨
踒	zcu·禾ㄋ丿一一
觭	hkeiue·角大一丨ㄋ一
袗	hdooo·衤人丿丿丿丿
蟏	bfu·虫艹ㄋ一一丨
蝲	bzi·虫束丨丨丨丨
蘘	fbiuei·艹亠丨ㄋ一丨
藠	fdoiue·艹白丿丨ㄋ一
薿	fnoeeo·艹匕丿一一丿
蕹	fbuuo·艹亠ㄋㄋ丿丿
蕗	fzour·艹丿ㄋ丶丨
蒇	fkiuor·艹戊丨ㄋ丿丶
萹	ftiue·艹户丨ㄋ一丨
萚	fgur·艹扌ㄋ丶一一
菼	fproor·艹火丶丿丿丶
菥	ftoo·艹木丿丿一丨
苠	fque·艹民ㄋ一ㄋ一
苊	fauu·艹厂ㄋㄋㄋㄋ
艴	xnouu·弓丿ㄋㄋ丨
腙	hveeio·月宀一一丨丿
腒	hzeiiu·月尸一丨丨ㄋ
耩	dpiuei·耒丨ㄋ一丨
耥	dciui·耒丨ㄋ丨ㄋ
耏	ywoo·而彡丿丿丿丿
羑	ktou·久丿ㄋ丶丶
纼	xxii·纟弓丨丨丨丨
箢	lvour·宀丿ㄋ丶ㄋ
筤	ljuee·丶ㄋ一一ㄋ
筢	lguieu·扌ㄋ丨一ㄋ
筀	lheie·圭一丨一一
竫	hbouu·立争丿ㄋㄋ一
稙	chei·禾直一丨丨ㄋ
稑	clore·禾土丿丶一丨
祊	hmreu·礻方丶一ㄋ丿
礤	dfourr·石艹丿ㄋ丶丶
礓	djiuei·石一丨ㄋ一丨
磹	dtiuee·石覀丨ㄋ一一
碨	dgeuor·石田一ㄋ丿丶
碃	dheeie·石青一一丨一
砮	cdeo·奴石一丿丨ㄋ
矼	dleiee·石工一丨一一
盉	cciui·禾皿丨ㄋ丨丨
瘊	ljueo·疒亻ㄋ一丿一
疰	lkree·疒主丶一一丨
甡	ggoee·生生丿一一丨
甗	dleuu·虍鬲一ㄋㄋ丶
瑀	sjiu·王丿丨ㄋ一丨
珽	sjie·王丿丨一丨一
玼	stiei·王此丨一丨一
獴	pweeou·犭一一丿ㄋ
猺	pyoe·犭爫丿一一丨
猇	pdouu·犭虍丿ㄋㄋㄋ
猃	pqrr·犭亼丶丶丿一
狉	pheee·犭不一一一一
牁	kgeiu·爿可一丨ㄋ一
爟	pfiuei·火艹丨ㄋ一丨
焌	pcoro·火厶丿丶丿ㄋ
澼	nbue·氵辟ㄋ一丿丨
漼	nyoire·氵山丿丨丶一
漻	nyoro·氵羽丿丶丿丿
漦	dneoi·未攵一丿丨ㄋ
溻	nwur·氵日ㄋ丶一ㄋ
湴	naii·氵䒑丨丨丶丿
浞	nkie·氵口丨一丿丶
泜	nmrr·氵氏丶丶丶丶
泙	nher·氵平一丶丿一
汧	nneeo·氵开一一丿丨
氇	wdiu·毛鱼丨ㄋ一一
氆	wai·毛䒑丨丨丶丿
檵	tpuur·木幺ㄋㄋ丶一
橥	pfeio·犭者一丨丿丶
榰	tfoui·木耂丿ㄋ丨ㄋ
榑	tfeir·木甫一丨丶丶
楩	tjeiu·木亻一丨ㄋ一
棽	mqorru·林今丿丶丶ㄋ
梠	tkiuee·木口丨ㄋ一一
桹	tjuee·木丶ㄋ一一ㄋ
桯	tkeeie·木口一一丨一
桊	lteior·木一丨丿丶
杕	tkeor·木大一丿丶丶
朓	hxreo·月儿丶一丿丶
昳	wjee·日丿一一丿丶
昫	wkiue·日勹丨ㄋ一一
摴	gpee·扌一一ㄋㄋ
搌	gzei·扌尸一丨丨一
揞	ghiuee·扌立丨ㄋ一一
扅	tbou·户夕丿ㄋ丶丶
戤	wfiu·乃又丨ㄋ丨丨
憭	hkroi·忄大丶丿丨ㄋ
悆	qtru·亼朩丶ㄋ丶丶
弸	xhoue·弓月丿ㄋ一一
弆	wneoi·去廾一丿丨丨
嶲	ymiui·山隹丨ㄋ丨丨
嶓	ymiue·山釆丨ㄋ一丨
嵁	yguu·山其ㄋㄋㄋㄋ
崞	yguiee·山ㄋ丨一一
崀	yjuee·山丶ㄋ一一ㄋ
峘	yjiu·山一丨ㄋ一一
宬	vkuuu·宀戊ㄋㄋㄋㄋ
婼	mfeo·女艹一丿丨ㄋ
婌	mlio·女上丨丿丶ㄋ
妧	mlee·女元一一丿ㄋ
堲	tweie·卩一丨一一
堉	lxiue·丨ㄋ一一
埯	lkiuee·土大丨ㄋ一一
埇	ltur·甬ㄋ丶丨ㄋ
圌	kyeoi·囗山一丿丨ㄋ
囧	kfiuu·口八丨ㄋㄋㄋ
嚄	kfoi·口艹丿丨丶一
噂	kdeir·口酋一丨丶丶
啴	khro·口单丶丿丨ㄋ
哿	tgeiu·加可一丨ㄋ一
哱	kpru·口十丶ㄋㄋ丨
匼	vcore·匚合丿丶一丨
匜	vduiu·匚也ㄋ丨ㄋㄋ
勔	hwuooo·面力ㄋ丿丿丿
劼	nwuoo·吉力ㄋ丿丿丿
儦	jmrrr·亻鹿丶丶丶丶
傺	jyee·亻一一丨丿
傉	jyei·亻辰一丨丶丶
偁	jyiue·亻爫丨ㄋ一丨
侘	jvoeu·亻宀丿一ㄋㄋ
侂	jaoe·亻广丿一ㄋㄋ
侁	jgoe·亻先丿一丨一
佴	jyeii·亻耳一丨丨一
齇	jgie·自畀丨一ㄋ丿
齄	jgei·自畀一丨丿丶
鼫	tdeoiu·鼠石一丿丨ㄋ
黇	paor·由丿丶丨一
鹠	pgour·田丿ㄋ丶ㄋ
鹟	cyour·公羽丿ㄋ丶ㄋ
鳛	dyoi·鱼羽丿丨ㄋ一
鳋	dfri·鱼又丶丨ㄋ一
鳁	dwiuii·鱼日丨ㄋ丨丨
鲪	dciuee·鱼尹丨ㄋ一一
鱽	dsuo·鱼刀ㄋ丿丿丿
骦	apei·马一丨丿丶
骣	azu·马尸ㄋ丨一ㄋ
骙	ayee·马癶一一丿丶
馇	ptiuee·饣木丨ㄋ一一
颋	sre·壬廴一丿丨ㄋ
靽	qjro·革半丶丿一一
靬	qnee·革干一一丨丨
隺	qmoi·冖隹丿丨丶一
阢	yjouu·阝一丿ㄋㄋㄋ
镥	vdiuee·钅鱼丨ㄋ一一
镤	vjro·钅业丶丿一一
镄	vxoii·钅弓丿丨丨ㄋ
锿	vgouo·钅丿ㄋ丿丶
锫	vhiue·钅立丨ㄋ一一
锘	vfeoi·钅艹一丿丨ㄋ
铻	vjiue·钅五丨ㄋ一一
铴	vnu·钅氵ㄋ丿丿丿
铕	vdiuee·钅丨ㄋ一一
钶	vaiuee·钅丁丨ㄋ一一
钘	vneeo·钅开一一丿丨
钋	vlir·钅卜丨丶丶丶
鄅	jkiuie·丿口丨ㄋ丨一
郪	jsuo·一肀ㄋ丿一ㄋ
轪	ykeo·车大一丿丶丶
谼	fdiuee·八人丨ㄋ一一
觟	hheie·角圭一丨一一
襫	hkeo·衤大一丿丨ㄋ
褟	hwur·衤日ㄋ丶一ㄋ
袯	hxuou·衤发ㄋ丿ㄋ丶
衃	gjiui·扌丿丨ㄋ丨丨
螵	btee·虫覀一一丨丿
螱	zseir·尸示一丨丶丨
螠	baor·虫䒑丿丶丨ㄋ
蛃	bfor·虫丙丿丶丶丶
蚄	bmre·虫方丶一ㄋ丿
虸	bsuie·虫子ㄋ丨一一
藦	fyoee·艹麻丿一一丨
薳	fnoio·艹吉丿丨丿丶
薁	fzro·艹丶丿一丨
蔈	fteei·艹覀一一丨丿
蓏	fyoo·艹瓜丿丿ㄋ丶
蓇	fmiuu·艹骨丨ㄋㄋ丶
葰	pcorou·𦫻厶丿丶丿ㄋ
葙	fveio·艹相一丨丿丶
葖	fdeor·艹穴一丿丶丶
莙	fciue·艹尹丨ㄋ一一
荖	ffouu·艹耂丿ㄋㄋㄋ
荓	faeo·艹䒑一丿丨丨
芣	fheoi·艹不一丿丨丶
艅	pqeior·舟亼一丨丿丶
胩	hlirrr·月上丨丶丶丶
耱	dyeoiu·耒麻一丿丨ㄋ
耤	dpiuee·耒龷丨ㄋ一一
翂	ysoru·羽分丿丶ㄋ丿
筘	lgiuee·扌丨ㄋ一一
笯	lmu·女ㄋ丶丶丶
穜	chiue·禾立丨ㄋ一一
穄	cye·禾一一丨丿
礵	dpeio·石一丨丿丶
礞	dwee·石一一丿ㄋ
磲	dneuu·石氵一ㄋㄋ一
磜	dyee·石一一丨丿
磏	dyroe·石兼丶丿一ㄋ
碏	dpiuee·石龷丨ㄋ一一
硿	ddeiee·石穴一丨一一
硍	dhue·石艮ㄋ一一ㄋ
硊	dhuu·石厃ㄋㄋㄋㄋ
砫	dkre·石主丶一一丨
砆	djee·石夫一一丿丶
睄	bciuee·目丨ㄋ一一
瘭	ltee·疒覀一一丨丿
瓻	hdiuie·乂丨ㄋ丨一
瓖	sbiu·王亠丨ㄋ一丨
璲	sweo·王丷一丿ㄋ丿
琄	skiuee·王口丨ㄋ一一
珷	sjeur·王一一ㄋ丶丨
珫	sxou·王丿ㄋㄋㄋ
珝	syure·王羽ㄋ丶一ㄋ
玱	sduu·王人ㄋㄋㄋㄋ
玭	smeu·王比一ㄋ丿ㄋ
玞	sjeeo·王夫一一丿丶
玙	sqee·王与一一一一
犋	cbor·牜丿丶丶丶
牚	caeu·牙一ㄋ丨丿
煺	phru·火艮丶ㄋ丶丶
煟	pgiuee·火田丨ㄋ一一
烻	pjie·火丿丨一丨一
炟	pqiu·火旦丨ㄋ一一
澂	nyeoe·氵山一丿一丿
淴	njrurr·氵勿丶ㄋ丶丶
淟	naorrr·氵曲丿丶丶丶
浰	ncii·氵禾丨丨丨丨
浕	nkrrrr·氵尺丶丶丶丶
洴	naeo·氵䒑一丿丨丨
沺	ngiuei·氵田丨ㄋ一丨
汭	nliuor·氵内丨ㄋ丿丶
欂	tyeiu·木落一丨ㄋ一
榀	tkiuei·木口丨ㄋ一丨
楱	tleeo·木一一丿丶
椸	tduiu·木𭤨ㄋ丨ㄋㄋ
梽	tlrur·木士丶ㄋ丶丶
梴	tjie·木丿丨一丨一
桲	tpru·木十丶ㄋㄋ丨
栻	tkeiee·木弋一丨一一
栟	taeo·木䒑一丿丨丨
晐	whreu·日亥丶一ㄋ丿
旴	wae·日于一一丨丨
敩	nsoeo·子丿一丿丶
攽	snoeor·分攵丿一丿丶
摏	gloi·扌丿丨一ㄋ
搋	gaieu·扌丨一ㄋ丿
揾	gwiui·扌日丨ㄋ丨丨
拤	glirr·扌上丨丶丶丶
扺	gmou·扌氏丿ㄋ一ㄋ
憙	akru·壴口丶ㄋ丶丶
幖	ytee·巾覀一一丨丿
嵲	yjeio·山自一丨丿丶
峿	yjiue·山五丨ㄋ一一
峧	yqorrr·山六丿丶丶丶
峗	yhuu·山厃ㄋㄋㄋㄋ
峃	nyiui·山丨ㄋ丨丨
岊	gyi·巴山丨ㄋ丨丨
嬬	mpeo·女一丿丨ㄋ
嬥	myoir·女羽丿丨丶一
嫭	mdor·女虍丿丶丿一
媱	myoe·女爫丿一一丨
媆	myeor·女而一丿丶丶
媄	mkeor·女一丿丶丶
婳	mjiu·女一丨ㄋ一丨
姽	mhuu·女厃ㄋㄋㄋㄋ
墚	lnu·土氵ㄋ丿一丨
墈	lguuo·其ㄋㄋ丿丿
塥	lleiu·土鬲一丨ㄋ一
塝	lhreuo·丶一ㄋ丿
垕	alei·一丨一一
垍	ljoi·自丿丨ㄋ一
嘡	kceie·口一丨一一
咺	kjiuee·口一丨ㄋ一一
咥	kgeur·口至一ㄋ丶一
咡	kyeiie·口耳一丨丨一
叚	que·叚ㄋ一丨一一
劁	mni·隹灬丨丨丨丨
剕	zniii·非刂丨丨丨丨
凵	suii·凵ㄋ丨丨丨丨
凓	wteior·冫覀一丨丿丶
冔	wkee·日口一一丨丨
儴	jbiu·亻亠丨ㄋ一丨
僎	jgue·亻巳ㄋ一ㄋ一
倴	jkeieo·亻大一丨一丿
倧	jveei·亻宀一一丨丿
俬	jcur·亻禾ㄋ丶丶丶
俙	jheoi·亻乂一丿丨ㄋ
俍	jjue·亻丶ㄋ一一ㄋ
佖	jlo·亻心丿丿丿丿
伾	jheee·亻不一一一一
伭	jbuu·亻亠ㄋㄋ丶丶
丏	ktuu·正ㄋㄋㄋㄋ
齉	jgeiu·自畀一丨ㄋ一
鼩	tkiuee·鼠勹丨ㄋ一一
鼒	tbu·才目ㄋ一丿丨
麖	mlre·鹿京丶一丨ㄋ
鹱	ffoir·鸟艹丿丨丶一
鹝	lfour·鬲鸟丿ㄋ丶ㄋ
鸼	pfour·舟鸟丿ㄋ丶ㄋ
鳡	dkeiue·鱼戊一丨ㄋ一
鳆	dviu·鱼丨ㄋ一一
鲺	dpo·鱼丿丨ㄋ一
鲝	kdouiu·鱼丿ㄋ丨ㄋ
鱾	dgueu·鱼己ㄋ一ㄋㄋ
髃	mwiuie·骨日丨ㄋ丨一
頔	adiue·由丆丨ㄋ一一
韂	qhor·革厃丿丶丶一
鞧	qdr·革酋丶丿一丨
霨	pze·尸一一丨丿
陑	yyeoi·阝而一丿丨ㄋ
陎	yjeei·阝丿丨丿丶丶
镎	vcoe·钅合丿一一丨
锖	vheei·钅青一一丨一
铽	vkru·钅弋丶ㄋ丶丶
铹	vwuooo·钅ㄋ丿丿丿
铥	vjeie·钅丿一丨一ㄋ
钸	vdiui·钅丨ㄋ丨丨
钷	vviu·钅匚丨ㄋ一一
釐	dneoiu·未攵一丿丨ㄋ
酅	ymiuo·山隹丨ㄋ丿丶
鄘	asiu·广肀丨ㄋ一一
鄑	swu·亚日ㄋ丨丨丨
鄌	asiue·广肀丨ㄋ一ㄋ
鄃	qhiiu·亼⺝丨丨ㄋ丨
鄀	fdiueu·艹丨ㄋ一ㄋ
郚	jkui·五口ㄋ丨丨丨
邘	ayuiii·于阝ㄋ丨丨丨
遆	hyru·巾丶ㄋ丶丶
辿	yrru·山辶丶ㄋ丶丶
轷	yboroe·车乎丿丶丿一
軎	ykiuee·車口丨ㄋ一一
蹾	zgu·ㄋ丨一丿
蹽	zkro·大丶丿丨ㄋ
貆	djiuee·豸一丨ㄋ一一
豮	hpeii·豕十一丨丨丨
誌	slrur·言士丶ㄋ丶丶
訄	gsre·九言丶一一一
觍	afiuo·曲八丨ㄋ丿ㄋ
觃	fsuie·见子ㄋ丨一一
褯	haeiie·衤广一丨丨一
袴	hkeeuu·衤大一一ㄋㄋ
蠧	bdiue·石丨ㄋ一丨
蟓	bwoui·虫象丿ㄋ丨ㄋ
蜐	bwu·虫去ㄋ丿丿丿
蚆	bguie·虫巴ㄋ丨一ㄋ
虤	daie·虍几丨一ㄋ丿
虍	die·虍丨一ㄋ丿一
薸	yteei·落覀一一丨丿
蔃	fxiue·艹弓丨ㄋ一丨
蒈	fmoiu·艹比丿丨ㄋ一
萳	fpiur·艹十丨ㄋ丶丿
菍	fqru·艹今丶ㄋ丶丶
莝	ffeiee·艹从一丨一一
荮	fxeir·艹纟一丨丶丶
荙	fkrurr·艹大丶ㄋ丶丶
荁	fjiuee·艹一丨ㄋ一一
茽	pviue·𦫻中丨ㄋ一丨
茓	fdrr·艹穴丶丶ㄋ丿
膪	hhiuii·月丨ㄋ丨丨
膙	hxiu·月弓丨ㄋ一丨
腨	hyeoi·月山一丿丨ㄋ
脟	hyeirr·月爫一丨丶丶
脎	hheio·月乂一丨丿丶
胈	hdurrr·月ㄋ丶丶丶
耢	dwuoo·耒ㄋ丿丿丿
耠	dcor·耒合丿丶一丨
耖	dvior·耒少丨丿丶丿
翷	qbeui·米夕一ㄋ丨ㄋ
翈	ayureu·甲羽ㄋ丶一ㄋ
羱	kaoi·厂丿丨ㄋ一
羓	kguieu·巴ㄋ丨一ㄋ
罶	cpiu·罒丨ㄋ一丨
缐	xdiuor·纟白丨ㄋ丿丶
簝	lkroi·大丶丿丨ㄋ
篯	lveeu·钅一一ㄋ丿
箖	lmeio·林一丨丿丶
筼	lkiuor·口丨ㄋ丿丶
筶	ljoei·告丿一丨一
筜	lcueee·ㄋ一一一
竘	hkiuee·立勹丨ㄋ一一
竑	hdurrr·立ㄋ丶丶丶
禤	hcur·礻罒ㄋ丶一ㄋ
禚	hkrrr·礻丶丶丶丶
祾	hlor·礻土丿丶丿ㄋ
祋	hdou·礻殳丿ㄋㄋ丶
砵	dteee·石木一一一一
砢	dgeiu·石可一丨ㄋ一
砠	dbiue·石且丨ㄋ一一
砄	dvor·石丿丶丶丶
瞫	btiuee·目覀丨ㄋ一一
盷	bkre·目勹丶一一一
皕	jdeo·一白一丿丨ㄋ
癗	lpiuei·疒丨ㄋ一丨
痓	lgeur·疒至一ㄋ丶一
痄	lzoeie·疒乍丿一丨一
痃	lbuu·疒亠ㄋㄋ丶丶
疭	lforor·疒从丿丶丿丶
疁	gyor·田羽丿丶丿丿
畖	gyoo·田瓜丿丿ㄋ丶
瓀	speoi·王一丿丨ㄋ
璬	sdre·王白丶一ㄋ丿
璥	sfou·王艹丿ㄋ丨ㄋ
璒	syeiu·王癶一丨ㄋ一
瑬	nxoiue·氵丿丨ㄋ一
瑝	sdeeie·王白一一丨一
瑖	sgoi·王段丿丨一一
瑔	sdiuo·王白丨ㄋ丿丶
瑆	swoe·王日丿一一丨
瑅	ssiuee·王是丨ㄋ一一
瑃	sliue·王丨ㄋ一一
瑂	sziu·王丨ㄋ一一
琡	slio·王上丨丿丶ㄋ
琟	smoir·王隹丿丨丶一
琔	sprr·王定丶丶ㄋ一
琎	syrur·王井丶ㄋ丶丶
琍	scii·王禾丨丨丨丨
琀	sqiuee·王今丨ㄋ一一
珹	skuu·王戊ㄋㄋㄋㄋ
珸	sjiue·王五丨ㄋ一一
珵	skeeie·王口一一丨一
珦	sziue·王丨ㄋ一一
珖	shir·王光丨丶丿一
珕	swuo·王力ㄋ丿ㄋ丿
珒	ssue·王聿ㄋ一一一
珇	sbiue·王且丨ㄋ一一
玿	ssiuee·王刀丨ㄋ一一
玹	sbu·王亠ㄋㄋ丶丶
玶	shero·王平一丶丿一
玓	skrr·王勹丶丶丶丶
玒	sleiee·王工一丨一一
猹	ptiuee·犭木丨ㄋ一一
猸	pziue·犭丨ㄋ一一
猯	pyeoi·犭山一丿丨ㄋ
猄	plre·犭京丶一丨ㄋ
犏	cti·牜户丨ㄋ一丨
牮	bcoee·代牛丿一一丨
牥	cmre·牜方丶一ㄋ丿
爔	pkeio·火一丨丿丶
燚	pproor·火火丶丿丿丶
熻	pcur·火合ㄋ丶一ㄋ
熥	ptru·火甬丶ㄋ丶丶
熜	pzoure·火丿ㄋ丶一
煃	pkeie·火大一丨一一
煁	pguu·火其ㄋㄋㄋㄋ
烶	psurr·火壬ㄋ丶丶丶
炣	pgeiu·火可一丨ㄋ一
炌	pdoii·火人丿丨丨丨
灈	nbiuee·氵目丨ㄋ一一
瀱	nceor·氵罒一丿丶丿
瀔	nbeo·氵一丿ㄋㄋ
澭	nbuuo·氵亠ㄋㄋ丿丿
潽	naiir·氵䒑丨丨丶丿
潵	npiuee·氵丨ㄋ一一
潖	nseei·氵王一一丨一
漹	nkuer·氵正ㄋ一丶丶
漷	ngui·氵ㄋ丨一ㄋ
漴	nyrr·氵山丶丶ㄋ一
漈	nyeei·氵一一丨丿
滍	nyeiu·氵屮一丨ㄋ一
溵	nauee·氵ㄋ一一丿
溠	nkeie·氵一丨一一
溚	nfore·氵艹丿丶一丨
溍	nsiue·氵亚丨ㄋ一一
溇	nquo·氵米ㄋ丿一一
湣	nqiuee·氵民丨ㄋ一一
湝	nmoi·氵比丿丨ㄋ一
渼	nkeor·氵一丿丶丶
淯	nxiue·氵丨ㄋ一一
涢	nkiuor·氵口丨ㄋ丿丶
涐	nwoe·氵我丿一丨一
涍	nfui·氵耂ㄋ丨一一
浲	nneeei·氵夂一一一丨
浭	nbei·氵更一丨ㄋ一
浟	njoeor·氵丿一丿丶
浛	nqiuee·氵今丨ㄋ一一
洭	nveeie·氵匚一一丨一
洨	nqorrr·氵六丿丶丶丶
洢	njue·氵亻ㄋ一一丿
洈	nhuu·氵厃ㄋㄋㄋㄋ
泃	nkiuee·氵勹丨ㄋ一一
泂	nsiuee·氵冂丨ㄋ一一
沘	nmeu·氵比一ㄋ丿ㄋ
沇	ncou·氵厶丿ㄋㄋㄋ
汫	nyeeo·氵井一一丿丨
汈	nteee·氵一一一一
氕	vjoo·气丿丿丿丿丿
毑	vduiuu·母也ㄋ丨ㄋㄋ
毌	vuue·毌ㄋㄋ一丨丨
歔	djou·虍业丿ㄋ丿丶
歅	tlou·覀土丿ㄋ丿丶
櫆	tsrr·木鬼丶丶一丨
榅	twiu·木日丨ㄋ丨丨
榃	mgiue·林田丨ㄋ一丨
楪	tdue·木廿ㄋ一丨丿
椪	taii·木䒑丨丨丶丿
梾	twio·木𰀆丨丿丶丶
梣	tyorr·木山丿丶丶ㄋ
梌	tqei·木亼一丨丿丶
栴	tviu·木丨ㄋ丶一
栐	tjuu·木丶ㄋㄋ丿丶
柖	tsiuee·木刀丨ㄋ一一
枍	tfeuu·木八一ㄋㄋㄋ
枅	tneeo·木开一一丿丨
杧	txre·木亡丶一ㄋㄋ
暲	wmei·日音一丨丨丨
暕	wzr·日束丶丶丶丶
暅	whei·日忄一丨ㄋ一
晱	wproor·日火丶丿丿丶
晊	wgeur·日至一ㄋ丶一
晅	wjiue·日一丨ㄋ一一
昪	wceo·日厶一丿丨丨
昤	wqor·日令丿丶丶ㄋ
昡	wbuu·日亠ㄋㄋ丶丶
昄	wau·日ㄋ丶丶丶
旿	wvei·日一丨丨丨
旵	wyiu·日山丨ㄋ丨丨
斶	qcoui·斤罒丿ㄋ丨ㄋ
攴	lfu·⺊又ㄋ丶丶丶
撖	gtei·扌乛一丨丨一
揳	gxuo·扌丰ㄋ丿一丿
挓	gvoe·扌宀丿一ㄋㄋ
扽	gbe·扌屯一ㄋ丨ㄋ
扂	ttie·户占丨一丨ㄋ
戭	vjiuei·宀一丨ㄋ一丨
憕	hyeiu·忄癶一丨ㄋ一
慬	hyeii·忄堇一丨丨一
慥	hjrur·忄告丶ㄋ丶丶
慓	hteei·忄覀一一丨丿
愭	hfou·忄耂丿ㄋ丨ㄋ
悈	hkeoi·忄戈一丿丨丨
弶	xlrei·弓京丶一丨ㄋ
弪	xpure·弓轻ㄋ丶一丨
廙	agei·广田一丨丨一
廆	asoiu·广鬼丿丨ㄋ一
庤	aleir·广土一丨丶丶
嶦	yhorr·山厃丿丶丶一
嶟	ydeir·山酋一丨丶丶
嶍	yyoi·山羽丿丨ㄋ一
嶅	kyiui·敖山丨ㄋ丨丨
嵖	ytiu·山木丨ㄋ一一
嵅	ykeiu·山戊一丨ㄋ一
崡	ycr·山了丶一丿丶
崌	yzei·山尸一丨丨ㄋ
峱	paiui·犭丑丨ㄋ丨丨
峂	ynr·山夂丶丶丶丶
屾	yyiui·山山丨ㄋ丨丨
宧	vqei·宀一丨丨ㄋ
媖	mfi·女艹丨ㄋ一丿
媓	mdee·女白一一丨一
媂	mhiui·女丨ㄋ丨丨
婻	mpiu·女十丨ㄋ丶丿
婫	mweu·女日一ㄋ丿ㄋ
婤	mseie·女冂一丨一丨
婍	mkei·女大一丨ㄋ一
娭	mcoe·女厶丿一一丿
姶	mcor·女合丿丶一丨
姈	mqorru·女令丿丶丶ㄋ
妭	mdur·女ㄋ丶丶丶
妘	mmee·女云一一ㄋ丶
墣	ljro·业丶丿一一
墘	lxeo·一丿ㄋㄋ
堽	lcei·罒一丨一丨
堼	hjeie·圭寸一丨一一
堧	lyeo·土而一丿丶丶
堎	lloro·土丿丶丿ㄋ
堌	lkeiiu·囗一丨丨ㄋ
埪	ldeiee·穴一丨一一
埌	ljueeu·丶ㄋ一一ㄋ
垵	lvuo·宀ㄋ丿一一
垯	lkru·大丶ㄋ丶丶
垙	lhir·光丨丶丿一
垎	lzouri·各丿ㄋ丶丨
坽	lqor·令丿丶丶ㄋ
坒	mlei·比土一丨一一
坋	lsor·分丿丶ㄋ丿
圲	lnoe·千丿一丨丨
圢	laeiii·丁一丨丨丨
圙	kfeoi·囗八一丿丨ㄋ
圐	kcre·囗罒丶一ㄋ丿
嚆	kfr·口艹丶一丨ㄋ
噇	khiuee·口立丨ㄋ一一
嘢	kgur·口里ㄋ丶ㄋ丨
唝	kliuor·口工丨ㄋ丿丶
哃	kseiu·口冂一丨ㄋ一
呇	nkiuee·水口丨ㄋ一一
厾	pweie·乙去一丨一ㄋ
勠	ydooou·羽人丿丿丿ㄋ
剋	vxiii·古儿丨丨丨丨
剅	hniiii·豆刂丨丨丨丨
凘	wgoo·冫其丿丿一丨
僔	jdeir·亻酋一丨丶丶
偡	jguu·亻其ㄋㄋㄋㄋ
倻	jyuiii·亻耳ㄋ丨丨丨
俫	jwio·亻𰀆丨丿丶丶
侹	jsurr·亻壬ㄋ丶丶丶
佸	jnoei·亻舌丿一丨丨
佁	jciuee·亻厶丨ㄋ一一
伣	jfiuo·亻见丨ㄋ丿ㄋ
乸	dvuu·也母ㄋㄋ丶一
𬺓	hmuieo·齿林ㄋ丨一丿
𬺈	hkeiue·齿大一丨ㄋ一
𬹼	hdoii·齿人丿丨丨丨
𬸪	mgou·釆田丿ㄋ丶ㄋ
𬸦	dmou·𭤨疋丿ㄋ丶ㄋ
𬸣	hfour·寒鸟丿ㄋ丶ㄋ
𬸚	pseor·犭讠一丿丶丶
𬸘	vwuoeo·匚日ㄋ丿一丿
𬷕	ffouru·甫鸟丿ㄋ丶ㄋ
𬶮	daiue·鱼壴丨ㄋ一一
𬶭	dyeei·鱼一一丨丿
𬶨	tnou·旡丿ㄋ丨ㄋ
𬶠	dzr·鱼束丶丶丶丶
𬶟	dzii·鱼束丨丨丨丨
𬶐	dxreo·鱼儿丶一丿丶
𬶏	dhuuu·鱼厃ㄋㄋㄋㄋ
𬶍	dvouu·鱼宀丿ㄋㄋㄋ
𬶋	dkiuee·鱼勹丨ㄋ一一
𬴊	aqo·马米丿ㄋ丶一
𬴃	axe·马丰一丿丨ㄋ
𬴂	azie·马非丨一一一
𬳿	aqe·马亼一丨丿丶
𬳽	agoe·马先丿一丨一
𬳶	asiuee·马冂丨ㄋ一一
𬳵	ahee·马不一一一一
𬱟	hgeo·厃一丿丨ㄋ
𬱖	aneoi·由页一丿丨ㄋ
𬯎	yliuor·阝丨ㄋ丿丶
𬯀	ynoi·阝文丿丨丨丨
𬮿	ygouu·阝己丿ㄋㄋㄋ
𬮱	fteie·门覀一丨一一
𬭼	vweo·钅丷一丿ㄋ丿
𬭸	vqour·钅米丿ㄋ丶一
𬭶	vxiur·钅黑丨ㄋ丶丿
𬭳	vaiuee·钅壴丨ㄋ一一
𬭯	vqoe·钅㡀丿一丿丶
𬭬	vxee·钅丰一一一丨
𬭩	vcur·钅公ㄋ丶一ㄋ
𬭤	vjue·钅亻ㄋ一丿一
𬭛	vnuo·钅氵ㄋ丿丨ㄋ
𬭚	vguie·钅ㄋ丨一一
𬭎	vveou·钅宀一丿ㄋ丶
𬭊	vtei·钅木一丨一一
𬭁	vvuu·钅母ㄋㄋ丶一
𬬿	vsiu·钅刀丨ㄋ一一
𬬻	vlue·钅⺊ㄋ一丿丿
𬬹	vwii·钅日丨丨丨丨
𬬸	vtr·钅木丶丶丶丶
𬬱	vqooe·钅斤丿丿一丨
𬬮	vboe·钅长丿一ㄋ丶
𬬭	vdou·钅人丿ㄋㄋㄋ
𬬩	vkeur·钅弋一ㄋ丶丶
𬪩	tlruo·酉农丶ㄋ丿ㄋ
𬩽	cjui·彐寸ㄋ丨丨丨
𬨎	ydro·车酋丶丿一丨
𬨂	ymou·车氏丿ㄋ一ㄋ
𬤝	sjiuee·讠一丨ㄋ一一
𬤊	ssiuee·讠是丨ㄋ一一
𬤇	ste·讠覀一丨一一
𬣳	shue·讠艮ㄋ一一ㄋ
𬣡	skeeu·讠戋一一ㄋ丿
𬣞	sveee·讠宀一一一一
𬣙	saee·讠于一一丨丨
𬟽	byio·虫丨丿丶丶
𬟁	flour·艹鬲丿ㄋ丶ㄋ
𬞟	fhio·艹止丨丿丿一
𬜯	fforor·艹丙丿丶丿丶
𬜬	ffiue·艹门丨ㄋ一一
𬙋	xbiue·纟亠丨ㄋ一丨
𬙊	xxe·纟黑一丨一一
𬙂	xveiu·纟宀一丨ㄋ一
𬘯	xgui·纟ㄋ丨一一
𬘭	xmei·纟林一丨丿丶
𬘬	xhee·纟青一一丨一
𬘫	xveeo·纟宀一一丿ㄋ
𬘩	xjie·纟丿丨一丨一
𬘡	xqiue·纟因丨ㄋ一丿
𬘘	xqou·纟冖丿ㄋㄋㄋ
𬘓	xwo·纟川丿丨丨丨
𬕂	lliuor·工丨ㄋ丿丶
𬒗	dliu·石丨ㄋ丿ㄋ
𬒔	dhiuee·石止丨ㄋ一一
𬒈	ndeo·石一丿丨ㄋ
𬍤	sce·王彐一丨丶丶
𬍡	ntooee·氵㇡丿丿一一
𬍛	spio·王丨丿丶丶
𬌗	acore·牙合丿丶一丨
𬊤	phro·火单丶丿丨ㄋ
𬊈	pce·火彐一丨丶丶
𬉼	pmeo·火区一丿丶ㄋ
𬇹	nkeei·氵囗一一丨一
𬇙	ndiuo·氵贝丨ㄋ丿丶
𬇕	nweu·氵万一ㄋ丿丿
𬃊	taeiiu·木一丨丨ㄋ
𬂩	twor·木𰀆丿丶丶丶
𬀪	wfiuo·日见丨ㄋ丿ㄋ
𬀩	wjeeu·日韦一一ㄋ丨
𫸩	xmeo·弓区一丿丶ㄋ
𫷷	avou·广钅丿ㄋ丿丶
𫶇	yfr·山丶ㄋ丨ㄋ
𫵷	yaeuo·山厂一ㄋ丿丿
𫰛	mpur·女轻ㄋ丶一丨
𫮃	lhroiu·单丶丿丨ㄋ
𫭼	lwuooo·ㄋ丿丿丿
𫭢	ldouu·人丿ㄋㄋㄋ
𫭟	lmeo·区一丿丶ㄋ
𫫇	ksru·口亚丶ㄋ丶丶
𫢸	jhro·亻单丶丿丨ㄋ
𫠜	htouu·齿臼丿ㄋㄋㄋ
𫠊	abu·马亠ㄋㄋ丶丶
𫠆	pfeo·十又一丿丨ㄋ
𫟼	vkrur·钅大丶ㄋ丶丶
𫟹	vpeii·钅共一丨丨一
𫟦	yweo·车丷一丿ㄋ丿
𫟅	xlreiu·纟京丶一丨ㄋ
𫞩	sfeiuo·王艹一丨ㄋ丿
𫛭	psou·犭王丿ㄋ丶ㄋ
𫚭	dwiueu·鱼巛丨ㄋ一ㄋ
𫚖	tdou·此鱼丿ㄋ丨ㄋ
𫚕	dneiu·鱼一丨ㄋ丨
𫘬	ayuu·马爫ㄋㄋ丶一
𫘪	aao·马厂丿丨ㄋ一
𫘨	asiuee·马是丨ㄋ一一
𫘧	acir·马丨丶一丿
𫘦	akoe·马勹丿一一丨
𫘝	avor·马丿丶丶丶
𫘜	anreo·马文丶一丿丶
𫗴	pbiui·饣亠丨ㄋ丨ㄋ
𫗧	pzei·饣束一丨ㄋ一
𫖳	ckeoi·尹口一丿丨ㄋ
𫖯	xneoi·儿一丿丨ㄋ
𫖮	ygeo·山己一丿丨ㄋ
𫔶	fjeio·门自一丨丿丶
𫔎	vhiuo·钅矛丨ㄋ丿丶
𫔍	vmiu·钅釆丨ㄋ一丨
𫓹	vgei·钅其一丨丨一
𫓶	vkiuee·钅口丨ㄋ一一
𫓯	vheie·钅圭一丨一一
𫓧	vjeeo·钅夫一一丿丶
𫑡	kwuui·口日ㄋㄋ丨丨
𫐓	yhei·车矛一丨丿丶
𫐐	ytou·车臼丿ㄋㄋㄋ
𫐄	yjouuu·车一丿ㄋㄋㄋ
𫍽	scei·讠罒一丨ㄋ一
𫍲	stiur·讠臼丨ㄋ丶丶
𫍯	skeiue·讠戊一丨ㄋ一
𫍣	sseiu·讠冂一丨ㄋ一
𫌀	hxiuo·礻丨ㄋ丿丶
𫇭	fjuo·艹丶ㄋ丿丶丶
𫄸	xniu·纟千丨ㄋ丶丿
𫄷	xmru·纟音丶ㄋ丶丶
𫄨	xheo·纟乂一丿丨ㄋ
𪾢	bfiuo·目见丨ㄋ丿ㄋ
𪩘	ypiu·山十丨ㄋ丶丿
𪨶	ykeue·山大一ㄋ一丨
𪨰	yaiuei·山曲丨ㄋ一丨
𪤗	lyoro·羽丿丶丿丿
𪣻	lquoe·米ㄋ丿一一
𪟝	xduo·贝ㄋ丿丿丿
𩾌	dauee·鱼广ㄋ一一丨
𩾃	dwouu·鱼丿ㄋㄋㄋ
𩽾	dvuo·鱼宀ㄋ丿一一
𨺙	ytouu·阝臼丿ㄋㄋㄋ
𨱔	vdei·钅酋一丨丶丶
𨱑	vpiue·钅丨ㄋ一丨
𨱏	vfor·钅艹丿丶一丨
𨱇	vweir·钅求一丨丶一
𨭉	njeuro·文一一ㄋ丶丿
𨟠	bboire·目目丿丨丶一
𨚕	cnui·厶廾ㄋ丨丨丨
𨙸	pfui·十又ㄋ丨丨丨
𨐈	yhir·车光丨丶丿一
𧿹	zvuu·母ㄋㄋ丶一
𦰡	fsuii·艹ㄋ丨丨丨
𦭜	fkor·艹口丿丶丶丶
𦝼	hquo·月米ㄋ丿一一
𦙶	hveiiu·月古一丨丨ㄋ
𦒍	hgur·立里ㄋ丶一ㄋ
𦈡	xpeo·纟一丿丨ㄋ
𥻗	qtiuee·米木丨ㄋ一一
𥖨	dkiuei·石口丨ㄋ一丨
𥕢	djiuei·石一丨ㄋ一丨
𥔲	dheeu·石吅一一ㄋㄋ
𤫉	spre·王火丶一一一
𤩽	spiuro·王十丨ㄋ丶丿
𤧛	shiui·王丨ㄋ丨丨
𣸣	npeiii·氵十一丨丨丨
𣲘	njeou·氵一一丿ㄋㄋ
𣲗	njeeu·氵韦一一ㄋ丨
𣗋	tcouu·木丿ㄋㄋㄋ
𡐓	lauee·广ㄋ一一丨
𡎚	ltiuei·户丨ㄋ一丨
𠳐	kxui·口ㄋ丨丨丨
𠙶	csuii·了凵ㄋ丨丨丨
𠅤	bgr·亠田丶ㄋ丶丶
鿏	vxour·钅丿ㄋ丶丶
鿎	dkru·石大丶ㄋ丶丶
鿍	lneui·夂一ㄋ丨丨
鼱	thee·鼠青一一丨一
鹲	wjeou·一一丿ㄋ丿
鹐	dtour·臼丿ㄋ丶ㄋ
鳤	dlrr·鱼丶丶ㄋ丨
鲘	daeiu·鱼一丨ㄋ一
鬶	jfei·夫见一丨ㄋ一
馧	cwiu·禾日丨ㄋ一一
馞	cweir·禾日一丨丶ㄋ
馝	cwru·禾日丶ㄋ丶丶
饻	pjre·饣衣丶一丿ㄋ
鄚	yyuii·莫阝ㄋ丨丨丨
邿	ljuii·土寸ㄋ丨丨丨
逎	trrur·酉辶丶ㄋ丶丶
蚲	bher·虫平一丶丿一
虷	bneei·虫干一一丨丨
蒄	wleir·元一丨丶丶
葴	fkeiu·艹戊一丨ㄋ一
萣	fprr·艹定丶丶ㄋ一
莿	fqii·艹朿丨丨丨丨
茋	fmrrrr·艹氏丶丶丶丶
苧	fveii·艹宀一丨丨丨
苉	fvouu·艹匚丿ㄋㄋㄋ
舥	pguie·舟巴ㄋ丨一ㄋ
胣	hvui·月ㄋ丨ㄋㄋ
翯	ygiue·羽丨ㄋ一一
粬	qai·米曲丨ㄋ一丨
穙	cjro·禾业丶丿一一
禒	haouoo·礻彑丿ㄋ丿丿
碈	dmiuee·石氏丨ㄋ一一
硔	dpeii·石共一丨丨一
癿	dpuu·白乙ㄋㄋㄋㄋ
璱	ssee·王王一一丨一
璮	sbiui·王亠丨ㄋ丨ㄋ
瑧	sloe·王丿一丨丿
瑓	szrr·王束丶丶丶丶
琈	syuie·王爫ㄋ丨一一
珢	shuee·王艮ㄋ一一ㄋ
珛	sdiue·王丨ㄋ一一
珋	spo·王卯丿ㄋ丿ㄋ
玤	sxe·王丰一一一丨
牻	cxoo·牜尢丿丿丿丶
煓	pyeoiu·火山一丿丨ㄋ
煋	pwoeei·火日丿一一丨
焆	pkiuee·火口丨ㄋ一一
烠	pdiuee·火丨ㄋ一一
瀌	nmrrr·氵鹿丶丶丶丶
濋	nmui·氵林ㄋ丨一丿
澽	ndeou·氵虍一丿ㄋ丿
澪	npor·氵丿丶丶ㄋ
潩	ngeiie·氵田一丨丨一
漤	nmuo·氵林ㄋ丿一一
漖	nfuie·氵耂ㄋ丨一丿
漋	nyou·氵阝丿ㄋ丶丿
滧	nqoro·氵六丿丶丿一
溹	nbuur·氵ㄋㄋ丶丨
溁	nweio·氵一丨丿丶
涄	naeu·氵由一ㄋㄋㄋ
洣	nqro·氵米丶丿一丨
洘	nfeu·氵耂一ㄋㄋㄋ
洓	nqeiu·氵朿一丨ㄋ丨
泇	ntuo·氵加ㄋ丿丨ㄋ
毪	wcoe·毛厶丿一一丨
檞	thuo·木角ㄋ丿丿一
橞	tjiuee·木一丨ㄋ一一
槜	tmu·木隹ㄋ丿丿丿
楒	tgr·木田丶ㄋ丶丶
椆	tseiei·木冂一丨一丨
棪	tproor·木火丶丿丿丶
棤	tpiuee·木龷丨ㄋ一一
栒	tkiuee·木勹丨ㄋ一一
杄	tnoei·木千丿一丨丨
朸	twuo·木力ㄋ丿丿丿
暿	waiu·日壴丨ㄋ一一
暶	wduie·日𭤨ㄋ丨一丿
晪	waor·日曲丿丶丶丶
昣	wdo·日人丿丿丿丿
旞	dweou·𭤨丷一丿ㄋ丿
揕	gguuu·扌其ㄋㄋㄋㄋ
戣	yfeu·癶天一ㄋ丿丶
愐	hheoiu·忄面一丿丨ㄋ
愃	hveiu·忄宀一丨ㄋ一
恔	hqorrr·忄六丿丶丶丶
徛	fkeiue·彳大一丨ㄋ一
彐	cuee·彐ㄋ一一一一
弨	xsiuee·弓刀丨ㄋ一一
庱	alo·广土丿丶丿ㄋ
崶	yheir·山圭一丨丶丶
峛	ybiii·山歹丨丨丨丨
峏	yyeoiu·山而一丿丨ㄋ
寁	vjuee·宀一ㄋ一一丨
墡	lkroei·羊丶丿一丨
墕	lkuer·正ㄋ一丶丶
塱	jtouee·丶丿ㄋ一一
堾	lliue·丨ㄋ一一
堐	laeie·厂一丨一一
埫	lciui·丨ㄋ丨ㄋ
垿	lauru·广ㄋ丶ㄋ丨
垾	lwee·日一一丨丨
垺	lyui·爫ㄋ丨一一
垏	lsue·聿ㄋ一一一
垈	bleie·代土一丨一一
坥	lbiuee·且丨ㄋ一一
坉	lbeu·屯一ㄋ丨ㄋ
圫	ljeuu·丿一ㄋㄋㄋ
咉	kseor·口冂一丿丶丶
叕	ffur·双双ㄋ丶ㄋ丶
劐	fmu·艹隹ㄋ丶丨丨
傃	jxuu·亻ㄋㄋ丶丨
侴	qjui·亼一ㄋ丨一一
䶮	lfee·龙天一一丿丶
䴙	bfou·辟鸟丿ㄋ丶ㄋ
䴘	adouo·虍丿ㄋ丿ㄋ
䴗	wpour·日犬丿ㄋ丶ㄋ
䴖	hfouru·青鸟丿ㄋ丶ㄋ
䴕	bnou·歹刂丿ㄋ丶ㄋ
䴔	qhou·六乂丿ㄋ丶ㄋ
䴓	jyou·一巾丿ㄋ丶ㄋ
䲢	hlou·月丿ㄋ丨ㄋ
䲠	dliue·鱼丨ㄋ一一
䲟	dpeui·鱼一ㄋ丨丨
䦃	vfeieo·钅艹一丨一丿
䥽	vxuo·钅发ㄋ丿ㄋ丶
䣘	clu·土ㄋ丨丨丨
䢼	pyuuii·共阝ㄋㄋ丨丨
䢺	ysuiii·屮凵ㄋ丨丨丨
䝙	dmeo·豸区一丿丶ㄋ
䗴	bloei·虫丿一丨一
䗪	dfrr·度又丶丶丶丶
䗛	bjour·虫丿ㄋ丶丨
䗖	bfr·虫丶ㄋ丨ㄋ
䕫	fdie·艹白丨一丨一
䓬	fliue·艹⺊丨ㄋ一一
䓫	fkeiue·艹大一丨ㄋ一
䓨	wyoe·缶丿一一丨
䓛	fzui·艹尸ㄋ丨丨ㄋ
䓖	fduo·艹穴ㄋ丿丿丿
䐃	hkeior·月囗一丨丿丶
䏲	hxrou·月弟丶丿ㄋ一
䏡	hsee·月示一一丨丿
䏝	hyurr·月二ㄋ丶丶丶
䎖	wyur·曾羽ㄋ丶一ㄋ
䎃	slu·冂土ㄋ丶一ㄋ
䌹	xsiuee·纟冂丨ㄋ一一
䅟	ccoo·禾丿丿丿丿
䃎	dkour·石大丿ㄋ丶丿
䃅	dhro·石单丶丿丨ㄋ
䂮	xseo·丰刀一丿丨ㄋ
䁖	bquo·目米ㄋ丿一一
㿠	dhir·白光丨丶丿一
㽏	nceii·氵合一丨丨一
㻬	speeu·王一一ㄋㄋ
㺄	pqiue·犭亼丨ㄋ一一
㸌	ppoi·火丿丨丶一
㸆	pjiee·火告丨一一一
㶲	ptoue·火用丿ㄋ一一
㵐	naroe·水厂丶丿一ㄋ
㴔	nxru·氵刍丶ㄋ丶丶
㳚	nkrrrr·氵戊丶丶丶丶
㳘	nxouu·氵丿ㄋㄋㄋ
㳇	nlor·氵父丿丶丿丶
㰀	tcoui·木禾丿ㄋ丨丶
㮾	jtouee·丶丿ㄋ一一
㭕	tweieu·木去一丨一ㄋ
㭎	tsorr·木冂丿丶丶丶
㬚	wxi·日丨ㄋ一一
㬎	wpuu·日ㄋㄋ丶丶
㬊	wyeeou·日爫一一丿ㄋ
㫰	wjue·日丶ㄋ一一ㄋ
㧟	gneu·扌氵一ㄋㄋㄋ
㧑	gjuor·扌丶ㄋ丿丶丶
㧐	gfuru·扌双ㄋ丶ㄋ丶
㥄	hloro·忄土丿丶丿ㄋ
㤘	hxouu·忄刍丿ㄋㄋ一
㠓	yweeo·山一一丿ㄋ
㠇	yleou·山京一丿ㄋ丶
㟃	ytei·山一丨ㄋ一
㛹	mjei·女亻一丨ㄋ一
㛚	mtu·女甬ㄋ丶丨ㄋ
㛃	xsuo·丰刀ㄋ丿一一
㙦	qtrre·亼朩丶丶一丨
㙘	ltuoe·土覀ㄋ丿一一
㙍	lfur·土双ㄋ丶ㄋ丶
㘎	kfue·口门ㄋ一丨丨
㕮	klor·口父丿丶丿丶
㑊	jpreo·亻亦丶一丿丨
㑇	jxouu·亻刍丿ㄋㄋ一
